30 100
ACGCTTATTTCCGGGGCCTTAATTCTCAGC|TTTGGCCCGAAGTACGGACTACCATACGAA
CCATACGAAATAAAATCCGGTTAGCAGCGG|CAAAGACCAATAGCCGGCGACCCTTGAGAG
ATTACCGTTCTTAGCGTCGCTCACGGTACG|CGCTACCATACGAAATAAAATCCGGTTAGC
CCACATCTTCCGGGGCTAATAAAGATTACC|GTGGGGGATCCGATTTTTCTGTGGCGCTAC
CGGAACGTGGCATCTTTATCCGAAGTTAGC|AAAATGAATTCGTCCTTGGGCGTTCGGAAG
AATAAAATCCGGTTAGCAGCGGTTAGCAGG|AATAGCCGGCGACCCTTGAGAGTGGGCCGT
CCATACGAAATAAAATCCGGTTAGCAGGTG|GTGGTGCTCTACCTGTTATCCTCAAATAAC
GTTAGCAGGTGTTTCCTGTCCCTACCATAC|CCTCAAATAACATAGTTGTGATTTAGTGCA
GACAACGTGCGCACGCGAAGGCGTTTTCAC|GTTAGCAGAGAGGAAAACCACGGGAGGGTT
TCCAGTCGACATTCCAATCAGGGAGGACGC|GTGGCATCTTTATCCGAAGTTAGCATTGCC
TAGCCGGAACGAACACGCTACGACAACGTG|TACCATACGAAATAAAATCCGGTTAGCAGA
CTGCTACCTACCATACGAAATAAAATCCGG|CGGTTAGCAGATAAAATCCTACCATACGAA
ACCATACCATCGTGCCACCCGGGGTTAGTA|AAATCCGGTTAGCAGAGGAGTAGAAATGTT
GCAGGGGATGAATAGGCCGCCAAAAAGGAA|CAAGCACTCATTTAAAATGCGTCGTTGTTA
AATCAGGGAGGACGCTTGGCCCATTCTCTC|GAAGTTAGCATTGCCGCCACTAGAAGGCGG
CCACGGGAGGGTTTGGCCCGAAGTACGGAC|CATTCTCTCCACATCTTCCGGGGCTAATAA
ATAAAATCCGGTTAGCAGTGCTCCTTACGG|ACTGGCTAGTTTTATGACGTCCCTCCGAAC
GTCCAAAGGAATCTCTCTAGTTCATTACAC|TCCGGTTAGCAGGTATCAAGGATATCTACC
CGGTTAGCAGTGCTCCTTACGGATCTACCA|GTTTTATGACGTCCCTCCGAACCGAGATCC
ATGAATAGGCCGCCAAAAAGGAATTGCGTA|TCATTTAAAATGCGTCGTTGTTAGCCGGAA
CTAGAAACTACCATACGAAATAAAATCCGG|CAGGGACCCTACCATACGAAATAAAATCCG
GTTAGCAGGGGCCGCTCTCTGCTCTTCTAC|GGATGAATAGGCCGCCAAAAAGGAATTGCG
GTGGCGCTACCATACGAAATAAAATCCGGT|TCGTGTCGAGACCCTGCTTAACGATTTTCC
GCTCTACCTGTTATCCTCAAATAACATAGT|TTCTTTCCAGCACGGGCAGTCGACCGCTCT
CCGGTTAGCAGTGGCCCTGCTACCTACCAT|CATACGAAATAAAATCCGGTTAGCAGATAA
ACGGGAGGGTTTGGCCCGAAGTACGGACTA|TTCTCTCCACATCTTCCGGGGCTAATAAAG
CTACGACAACGTGCGCACGCGAAGGCGTTT|TCCGGTTAGCAGAGAGGAAAACCACGGGAG
TACGACTAGCTACCATACGAAATAAAATCC|AACGAACACGCTACGACAACGTGCGCACGC
GAAATAAAATCCGGTTAGCAGTGCTCCTTA|CAGACTGGCTAGTTTTATGACGTCCCTCCG
CGAAGTACGGACTACCATACGAAATAAAAT|CGGGGCTAATAAAGATTACCGTTCTTAGCG
CTAGAAGGCGGTGGGGGATCCGATTTTTCT|TTTTAGTGAAGCAGGTTTGTGTTCATCACA
ACGGACTACCATACGAAATAAAATCCGGTT|TAATAAAGATTACCGTTCTTAGCGTCGCTC
GCTACCATACGAAATAAAATCCGGTTAGCA|CGAGCTTCAACCGGAGCACGAGGAGTCCAA
AGCAGAGGAGTAGAAATGTTTAGCGCAACG|GCGTTTTCACGCTTATTTCCGGGGCCTTAA
TAGTAACGGCTTGCTGTCCTAGAAACTACC|GTTAGCAGGAAGTCCTCACAGGGACCCTAC
ATTGCGTACGACTAGCTACCATACGAAATA|AGCCGGAACGAACACGCTACGACAACGTGC
CCCATTCTCTCCACATCTTCCGGGGCTAAT|CTAGAAGGCGGTGGGGGATCCGATTTTTCT
CTCAAATAACATAGTTGTGATTTAGTGCAA|GCAGTCGACCGCTCTACCATACGAAATAAA
TTACACCTGGCACGGCTTCAAAGACCAATA|TCTACCATACGAAATAAAATCCGGTTAGCA
CAGAGAGGAAAACCACGGGAGGGTTTGGCC|GGACGCTTGGCCCATTCTCTCCACATCTTC
CATACGAAATAAAATCCGGTTAGCAGGACA|ACCCTGCTTAACGATTTTCCTAGCAGACAC
GGCCCGAAGTACGGACTACCATACGAAATA|CTTCCGGGGCTAATAAAGATTACCGTTCTT
CCGGGGTTAGTAGCATCATGTATTAAGCTA|AGTAGAAATGTTTAGCGCAACGAAAACGAG
CCGGTTAGCAGACTGGCTAGTTTTATGACG|TCGCTCACGGTACGCTAAAACTTGATTAAG
CACGGGCAGTCGACCGCTCTACCATACGAA|CCCTACGACCATACCATCGTGCCACCCGGG
CAGCTATGGGAAGCCTACCATACGAAATAA|GCAGGTGTTTCCTGTCCCTACCATACGAAC
CTACCATACGAACTACCATACGAAATAAAA|TTTAGTGCAAGGTCCAAAGGAATCTCTCTA
AAGGAATCTCTCTAGTTCATTACACCTGGC|TTAGCAGGTATCAAGGATATCTACCATACG
GTACGACTAGCTACCATACGAAATAAAATC|GAACGAACACGCTACGACAACGTGCGCACG
ATGTTTAGCGCAACGAAAACGAGCTTCAAC|TTTCCGGGGCCTTAATTCTCAGCTCACTAC
ACCTGTTATCCTCAAATAACATAGTTGTGA|TCCAGCACGGGCAGTCGACCGCTCTACCAT
TAAAATCCGGTTAGCAGGTGTTTCCTGTCC|ACCTGTTATCCTCAAATAACATAGTTGTGA
GCTTGGCCCATTCTCTCCACATCTTCCGGG|CCGCCACTAGAAGGCGGTGGGGGATCCGAT
CCGGTTAGCAGGTATCAAGGATATCTACCA|GCATCATGTATTAAGCTACCATACGAAATA
TAAGGGCTTAGGGGCGGAACGTGGCATCTT|TTCGAAAGTCCGATAAAATGAATTCGTCCT
GCTTATTTCCGGGGCCTTAATTCTCAGCTC|TGGCCCGAAGTACGGACTACCATACGAAAT
ACCCGGGGTTAGTAGCATCATGTATTAAGC|GGAGTAGAAATGTTTAGCGCAACGAAAACG
AAAATCCGGTTAGCAGTGGCCCTGCTACCT|ACTACCATACGAAATAAAATCCGGTTAGCA
TACCATACGAAATAAAATCCGGTTAGCAGA|GATCCAGTCGACATTCCAATCAGGGAGGAC
GCTAAAACTTGATTAAGGGCTTAGGGGCGG|CAGGACACTTGCCTTCGAAAGTCCGATAAA
GGCCGTCGGTTTCTTTCCAGCACGGGCAGT|TACACGCTTTTCAATGAGCCCCCTACGACC
CATTTAAAATGCGTCGTTGTTAGCCGGAAC|AGCAGTGCTCCTTACGGATCTACCATACGA
CGGTTAGCAGGACACTTGCCTTCGAAAGTC|TTCCTAGCAGACACTTGCTCAGCTCGACCA
TACCATACGAAATAAAATCCGGTTAGCAGG|TGCCACCCGGGGTTAGTAGCATCATGTATT
CCGGTTAGCAGAGAGGAAAACCACGGGAGG|ATCAGGGAGGACGCTTGGCCCATTCTCTCC
GACTACCATACGAAATAAAATCCGGTTAGC|TAAAGATTACCGTTCTTAGCGTCGCTCACG
GCGTTTTCACGCTTATTTCCGGGGCCTTAA|CGGGAGGGTTTGGCCCGAAGTACGGACTAC
CAATGAGCCCCCTACGACCATACCATCGTG|GCTACCATACGAAATAAAATCCGGTTAGCA
CTTCAAAGACCAATAGCCGGCGACCCTTGA|AAAATCCGGTTAGCAGGGGCCGCTCTCTGC
CTTTCCAGCACGGGCAGTCGACCGCTCTAC|AATGAGCCCCCTACGACCATACCATCGTGC
CAATAGCCGGCGACCCTTGAGAGTGGGCCG|TAGCAGGGGCCGCTCTCTGCTCTTCTACAC
AGGAAGTCCTCACAGGGACCCTACCATACG|ATCCGGTTAGCAGCGGTTAGCAGGTGGTGC
CCCTCCGAACCGAGATCCAGTCGACATTCC|GCTTAGGGGCGGAACGTGGCATCTTTATCC
GTTAGCAGACTGGCTAGTTTTATGACGTCC|CTCACGGTACGCTAAAACTTGATTAAGGGC
AATCCGGTTAGCAGGTATCAAGGATATCTA|GTAGCATCATGTATTAAGCTACCATACGAA
AATAAAATCCGGTTAGCAGCTATGGGAAGC|AAATAAAATCCGGTTAGCAGGTGTTTCCTG
GGAACGAACACGCTACGACAACGTGCGCAC|TACGAAATAAAATCCGGTTAGCAGAGAGGA
AATAAAATCCGGTTAGCAGGTATCAAGGAT|GGTTAGTAGCATCATGTATTAAGCTACCAT
ATGGGAAGCCTACCATACGAAATAAAATCC|TGTTTCCTGTCCCTACCATACGAACTACCA
CCGGCGACCCTTGAGAGTGGGCCGTCGGTT|GGGCCGCTCTCTGCTCTTCTACACGCTTTT
GGTCCAAAGGAATCTCTCTAGTTCATTACA|ATCCGGTTAGCAGGTATCAAGGATATCTAC
AGAAATGTTTAGCGCAACGAAAACGAGCTT|CTTATTTCCGGGGCCTTAATTCTCAGCTCA
ATAAAATCCGGTTAGCAGAGGAGTAGAAAT|TGCGCACGCGAAGGCGTTTTCACGCTTATT
TACGGATCTACCATACGAAATAAAATCCGG|CGAACCGAGATCCAGTCGACATTCCAATCA
AAATCCGGTTAGCAGATAAAATCCTACCAT|CTAGTTCATTACACCTGGCACGGCTTCAAA
TAAAATCCGGTTAGCAGCTATGGGAAGCCT|ATAAAATCCGGTTAGCAGGTGTTTCCTGTC
TCAAATAACATAGTTGTGATTTAGTGCAAG|CAGTCGACCGCTCTACCATACGAAATAAAA
CGCTACGACAACGTGCGCACGCGAAGGCGT|AATCCGGTTAGCAGAGAGGAAAACCACGGG
AGGAAAACCACGGGAGGGTTTGGCCCGAAG|CTTGGCCCATTCTCTCCACATCTTCCGGGG
CCTGGCACGGCTTCAAAGACCAATAGCCGG|CATACGAAATAAAATCCGGTTAGCAGGGGC
CATACGAAATAAAATCCGGTTAGCAGGGGA|TTCAACCGGAGCACGAGGAGTCCAAGCACT
CTCTAGTTCATTACACCTGGCACGGCTTCA|ATCAAGGATATCTACCATACGAAATAAAAT
ATACCATCGTGCCACCCGGGGTTAGTAGCA|TCCGGTTAGCAGAGGAGTAGAAATGTTTAG
AGAGGAAAACCACGGGAGGGTTTGGCCCGA|CGCTTGGCCCATTCTCTCCACATCTTCCGG
CGGTTAGCAGGAAGTCCTCACAGGGACCCT|GAAATAAAATCCGGTTAGCAGCGGTTAGCA
GCAGGGGCCGCTCTCTGCTCTTCTACACGC|GAATAGGCCGCCAAAAAGGAATTGCGTACG
TAATTCTCAGCTCACTACTACCATACGAAA|TACCATACGAAATAAAATCCGGTTAGCAGA
CGAAATAAAATCCGGTTAGCAGCTATGGGA|ACGAAATAAAATCCGGTTAGCAGGTGTTTC
TACCATACGAAATAAAATCCGGTTAGCAGT|CCCTACCATACGAACTACCATACGAAATAA
TCTCCACATCTTCCGGGGCTAATAAAGATT|GCGGTGGGGGATCCGATTTTTCTGTGGCGC
CCCTACCATACGAAATAAAATCCGGTTAGC|AGCAGGTGGTGCTCTACCTGTTATCCTCAA
CCATACGAAATAAAATCCGGTTAGCAGAGG|ACGACAACGTGCGCACGCGAAGGCGTTTTC
GAAACTACCATACGAAATAAAATCCGGTTA|GGACCCTACCATACGAAATAAAATCCGGTT
ATCCGGTTAGCAGGGGCCGCTCTCTGCTCT|GCAGGGGATGAATAGGCCGCCAAAAAGGAA
CTTATTTCCGGGGCCTTAATTCTCAGCTCA|GGCCCGAAGTACGGACTACCATACGAAATA
ATACGAAATAAAATCCGGTTAGCAGGTATC|ACCCGGGGTTAGTAGCATCATGTATTAAGC
TTCAATGAGCCCCCTACGACCATACCATCG|TAGCTACCATACGAAATAAAATCCGGTTAG
ATAACATAGTTGTGATTTAGTGCAAGGTCC|CGACCGCTCTACCATACGAAATAAAATCCG
AATCCGGTTAGCAGTGCTCCTTACGGATCT|GCTAGTTTTATGACGTCCCTCCGAACCGAG
TACCATACGAAATAAAATCCGGTTAGCAGG|AGCTTCAACCGGAGCACGAGGAGTCCAAGC
CAATCAGGGAGGACGCTTGGCCCATTCTCT|CGAAGTTAGCATTGCCGCCACTAGAAGGCG
AGTGCAAGGTCCAAAGGAATCTCTCTAGTT|AAATAAAATCCGGTTAGCAGGTATCAAGGA
CCTAGAAACTACCATACGAAATAAAATCCG|ACAGGGACCCTACCATACGAAATAAAATCC
CTACCATACGAAATAAAATCCGGTTAGCAG|TCCGGTTAGCAGACTGGCTAGTTTTATGAC
ACATAGTTGTGATTTAGTGCAAGGTCCAAA|CCGCTCTACCATACGAAATAAAATCCGGTT
AGTCCTCACAGGGACCCTACCATACGAAAT|GGTTAGCAGCGGTTAGCAGGTGGTGCTCTA
GGGGATGAATAGGCCGCCAAAAAGGAATTG|GCACTCATTTAAAATGCGTCGTTGTTAGCC
TCTAGTTCATTACACCTGGCACGGCTTCAA|TCAAGGATATCTACCATACGAAATAAAATC
ACTACCATACGAAATAAAATCCGGTTAGCA|ATCCGGTTAGCAGACTGGCTAGTTTTATGA
CGAGATCCAGTCGACATTCCAATCAGGGAG|GGAACGTGGCATCTTTATCCGAAGTTAGCA
AGATAAAATCCTACCATACGAAATAAAATC|CCTGGCACGGCTTCAAAGACCAATAGCCGG
TTGCGTACGACTAGCTACCATACGAAATAA|GCCGGAACGAACACGCTACGACAACGTGCG
CTTCAACCGGAGCACGAGGAGTCCAAGCAC|TCACTACTACCATACGAAATAAAATCCGGT
GGGGCCGCTCTCTGCTCTTCTACACGCTTT|TAGGCCGCCAAAAAGGAATTGCGTACGACT
GTCGACATTCCAATCAGGGAGGACGCTTGG|CATCTTTATCCGAAGTTAGCATTGCCGCCA
AAAATGCGTCGTTGTTAGCCGGAACGAACA|TGCTCCTTACGGATCTACCATACGAAATAA
CCATACGAAATAAAATCCGGTTAGCAGTGG|CTACCATACGAACTACCATACGAAATAAAA
GTAACGGCTTGCTGTCCTAGAAACTACCAT|TAGCAGGAAGTCCTCACAGGGACCCTACCA
ATCCGGTTAGCAGAGGAGTAGAAATGTTTA|ACGCGAAGGCGTTTTCACGCTTATTTCCGG
TTAGCAGGAAGTCCTCACAGGGACCCTACC|ATAAAATCCGGTTAGCAGCGGTTAGCAGGT
AACGGCTTGCTGTCCTAGAAACTACCATAC|GCAGGAAGTCCTCACAGGGACCCTACCATA
ATACGAAATAAAATCCGGTTAGCAGGTGTT|GGTGCTCTACCTGTTATCCTCAAATAACAT
AACGAACACGCTACGACAACGTGCGCACGC|CGAAATAAAATCCGGTTAGCAGAGAGGAAA
CCGGGGCCTTAATTCTCAGCTCACTACTAC|AGTACGGACTACCATACGAAATAAAATCCG
AAAATCCGGTTAGCAGACTGGCTAGTTTTA|TAGCGTCGCTCACGGTACGCTAAAACTTGA
AGTCGACATTCCAATCAGGGAGGACGCTTG|GCATCTTTATCCGAAGTTAGCATTGCCGCC
TAGCAGGAAGTCCTCACAGGGACCCTACCA|TAAAATCCGGTTAGCAGCGGTTAGCAGGTG
CGGTTAGCAGGGGCCGCTCTCTGCTCTTCT|GGGGATGAATAGGCCGCCAAAAAGGAATTG
TTAGGGGCGGAACGTGGCATCTTTATCCGA|GTCCGATAAAATGAATTCGTCCTTGGGCGT
GACCATACCATCGTGCCACCCGGGGTTAGT|AAAATCCGGTTAGCAGAGGAGTAGAAATGT
CTAGCTACCATACGAAATAAAATCCGGTTA|ACACGCTACGACAACGTGCGCACGCGAAGG
CAACCGGAGCACGAGGAGTCCAAGCACTCA|CTACTACCATACGAAATAAAATCCGGTTAG
TGACGTCCCTCCGAACCGAGATCCAGTCGA|TTAAGGGCTTAGGGGCGGAACGTGGCATCT
AGAGGAGTAGAAATGTTTAGCGCAACGAAA|TTTTCACGCTTATTTCCGGGGCCTTAATTC
TCCGGTTAGCAGGGGCCGCTCTCTGCTCTT|CAGGGGATGAATAGGCCGCCAAAAAGGAAT
AGTCGACCGCTCTACCATACGAAATAAAAT|ACCATACCATCGTGCCACCCGGGGTTAGTA
ATACGAAATAAAATCCGGTTAGCAGGACAC|CCCTGCTTAACGATTTTCCTAGCAGACACT
GAGATCCAGTCGACATTCCAATCAGGGAGG|GAACGTGGCATCTTTATCCGAAGTTAGCAT
ATTCCAATCAGGGAGGACGCTTGGCCCATT|TATCCGAAGTTAGCATTGCCGCCACTAGAA
TAAAATGCGTCGTTGTTAGCCGGAACGAAC|GTGCTCCTTACGGATCTACCATACGAAATA
TTCCTGTCCCTACCATACGAACTACCATAC|TAGTTGTGATTTAGTGCAAGGTCCAAAGGA
TGCCACCCGGGGTTAGTAGCATCATGTATT|CAGAGGAGTAGAAATGTTTAGCGCAACGAA
TACCATACGAAATAAAATCCGGTTAGCAGG|GAGACCCTGCTTAACGATTTTCCTAGCAGA
TTGCCGCCACTAGAAGGCGGTGGGGGATCC|AAGCGCGCGTTTTAGTGAAGCAGGTTTGTG
GGCATCTTTATCCGAAGTTAGCATTGCCGC|TTCGTCCTTGGGCGTTCGGAAGCAAGCGCG
TCCGGGGCTAATAAAGATTACCGTTCTTAG|TCCGATTTTTCTGTGGCGCTACCATACGAA
AACGAAAACGAGCTTCAACCGGAGCACGAG|TTAATTCTCAGCTCACTACTACCATACGAA
ATACGAAATAAAATCCGGTTAGCAGGAAGT|AAAATCCTACCATACGAAATAAAATCCGGT
CACGCTACGACAACGTGCGCACGCGAAGGC|AAAATCCGGTTAGCAGAGAGGAAAACCACG
GTTGTTAGCCGGAACGAACACGCTACGACA|GGATCTACCATACGAAATAAAATCCGGTTA
AAATAACATAGTTGTGATTTAGTGCAAGGT|GTCGACCGCTCTACCATACGAAATAAAATC
CGTTCTTAGCGTCGCTCACGGTACGCTAAA|CCATACGAAATAAAATCCGGTTAGCAGGAC
TCTTAGCGTCGCTCACGGTACGCTAAAACT|TACGAAATAAAATCCGGTTAGCAGGACACT
AGCGCAACGAAAACGAGCTTCAACCGGAGC|GGGCCTTAATTCTCAGCTCACTACTACCAT
AGGGAGGACGCTTGGCCCATTCTCTCCACA|TTAGCATTGCCGCCACTAGAAGGCGGTGGG
TTTATCCGAAGTTAGCATTGCCGCCACTAG|CTTGGGCGTTCGGAAGCAAGCGCGCGTTTT
TACGACCATACCATCGTGCCACCCGGGGTT|AATAAAATCCGGTTAGCAGAGGAGTAGAAA
CCGAACCGAGATCCAGTCGACATTCCAATC|AGGGGCGGAACGTGGCATCTTTATCCGAAG
AAATCCGGTTAGCAGGAAGTCCTCACAGGG|CATACGAAATAAAATCCGGTTAGCAGCGGT
TTACGGATCTACCATACGAAATAAAATCCG|CCGAACCGAGATCCAGTCGACATTCCAATC
CTAATAAAGATTACCGTTCTTAGCGTCGCT|TTTCTGTGGCGCTACCATACGAAATAAAAT
GTTAGCAGTGGCCCTGCTACCTACCATACG|ACGAAATAAAATCCGGTTAGCAGATAAAAT
ACGAAATAAAATCCGGTTAGCAGGTGTTTC|TGCTCTACCTGTTATCCTCAAATAACATAG
CCGAGATCCAGTCGACATTCCAATCAGGGA|CGGAACGTGGCATCTTTATCCGAAGTTAGC
GAAATAAAATCCGGTTAGCAGATAAAATCC|ATCTCTCTAGTTCATTACACCTGGCACGGC
CAGTCGACATTCCAATCAGGGAGGACGCTT|GGCATCTTTATCCGAAGTTAGCATTGCCGC
AAGTTAGCATTGCCGCCACTAGAAGGCGGT|TTCGGAAGCAAGCGCGCGTTTTAGTGAAGC
TTAGCATTGCCGCCACTAGAAGGCGGTGGG|GGAAGCAAGCGCGCGTTTTAGTGAAGCAGG
ATACGAAATAAAATCCGGTTAGCAGCTATG|CATACGAAATAAAATCCGGTTAGCAGGTGT
CGGTTTCTTTCCAGCACGGGCAGTCGACCG|CTTTTCAATGAGCCCCCTACGACCATACCA
TTAGCCGGAACGAACACGCTACGACAACGT|CTACCATACGAAATAAAATCCGGTTAGCAG
AACGAGCTTCAACCGGAGCACGAGGAGTCC|CTCAGCTCACTACTACCATACGAAATAAAA
CCTACCATACGAAATAAAATCCGGTTAGCA|GCTTCAAAGACCAATAGCCGGCGACCCTTG
GCCGGAACGAACACGCTACGACAACGTGCG|CCATACGAAATAAAATCCGGTTAGCAGAGA
TCCGGTTAGCAGTGGCCCTGCTACCTACCA|CCATACGAAATAAAATCCGGTTAGCAGATA
ATCCGGTTAGCAGGGGATGAATAGGCCGCC|CGAGGAGTCCAAGCACTCATTTAAAATGCG
CGAAATAAAATCCGGTTAGCAGTGCTCCTT|GCAGACTGGCTAGTTTTATGACGTCCCTCC
CTTACGGATCTACCATACGAAATAAAATCC|TCCGAACCGAGATCCAGTCGACATTCCAAT
AAAATCCGGTTAGCAGGTATCAAGGATATC|TAGTAGCATCATGTATTAAGCTACCATACG
TTATTTCCGGGGCCTTAATTCTCAGCTCAC|GCCCGAAGTACGGACTACCATACGAAATAA
ACCACGGGAGGGTTTGGCCCGAAGTACGGA|CCATTCTCTCCACATCTTCCGGGGCTAATA
AGCATCATGTATTAAGCTACCATACGAAAT|TTAGCGCAACGAAAACGAGCTTCAACCGGA
TACCGTTCTTAGCGTCGCTCACGGTACGCT|CTACCATACGAAATAAAATCCGGTTAGCAG
AGTCCAAGCACTCATTTAAAATGCGTCGTT|TAAAATCCGGTTAGCAGTGCTCCTTACGGA
ATAAAATCCGGTTAGCAGCTATGGGAAGCC|AATAAAATCCGGTTAGCAGGTGTTTCCTGT
GCGTACGACTAGCTACCATACGAAATAAAA|CGGAACGAACACGCTACGACAACGTGCGCA
CAGGAAGTCCTCACAGGGACCCTACCATAC|AATCCGGTTAGCAGCGGTTAGCAGGTGGTG
GGGGCGGAACGTGGCATCTTTATCCGAAGT|CGATAAAATGAATTCGTCCTTGGGCGTTCG
GGACCCTACCATACGAAATAAAATCCGGTT|GTTAGCAGGTGGTGCTCTACCTGTTATCCT
ATCCGGTTAGCAGCGGTTAGCAGGTGGTGC|CGGCGACCCTTGAGAGTGGGCCGTCGGTTT
TAGCAGACTGGCTAGTTTTATGACGTCCCT|CACGGTACGCTAAAACTTGATTAAGGGCTT
GGTTAGCAGACTGGCTAGTTTTATGACGTC|GCTCACGGTACGCTAAAACTTGATTAAGGG
CATAGTTGTGATTTAGTGCAAGGTCCAAAG|CGCTCTACCATACGAAATAAAATCCGGTTA
GTATTAAGCTACCATACGAAATAAAATCCG|ACGAAAACGAGCTTCAACCGGAGCACGAGG
ATCCGAAGTTAGCATTGCCGCCACTAGAAG|GGGCGTTCGGAAGCAAGCGCGCGTTTTAGT
CCTTGAGAGTGGGCCGTCGGTTTCTTTCCA|CTCTGCTCTTCTACACGCTTTTCAATGAGC
CGGTGGGGGATCCGATTTTTCTGTGGCGCT|AAGCAGGTTTGTGTTCATCACATCGTGTCG
GAGGACGCTTGGCCCATTCTCTCCACATCT|GCATTGCCGCCACTAGAAGGCGGTGGGGGA
GAACGTGGCATCTTTATCCGAAGTTAGCAT|AATGAATTCGTCCTTGGGCGTTCGGAAGCA
GCAGGAAGTCCTCACAGGGACCCTACCATA|AAATCCGGTTAGCAGCGGTTAGCAGGTGGT
CATACGAAATAAAATCCGGTTAGCAGTGGC|TACCATACGAACTACCATACGAAATAAAAT
CATTCCAATCAGGGAGGACGCTTGGCCCAT|TTATCCGAAGTTAGCATTGCCGCCACTAGA
AACCACGGGAGGGTTTGGCCCGAAGTACGG|CCCATTCTCTCCACATCTTCCGGGGCTAAT
TCCAAAGGAATCTCTCTAGTTCATTACACC|CCGGTTAGCAGGTATCAAGGATATCTACCA
GGTTAGCAGGGGCCGCTCTCTGCTCTTCTA|GGGATGAATAGGCCGCCAAAAAGGAATTGC
TACCATACGAAATAAAATCCGGTTAGCAGA|AGATTACCGTTCTTAGCGTCGCTCACGGTA
TACCATACGAAATAAAATCCGGTTAGCAGA|CTACGACAACGTGCGCACGCGAAGGCGTTT
CTCACGGTACGCTAAAACTTGATTAAGGGC|ATCCGGTTAGCAGGACACTTGCCTTCGAAA
AACACGCTACGACAACGTGCGCACGCGAAG|ATAAAATCCGGTTAGCAGAGAGGAAAACCA
CCCCTACGACCATACCATCGTGCCACCCGG|ACGAAATAAAATCCGGTTAGCAGAGGAGTA
CAGACTGGCTAGTTTTATGACGTCCCTCCG|GGTACGCTAAAACTTGATTAAGGGCTTAGG
ACGAACTACCATACGAAATAAAATCCGGTT|CAAGGTCCAAAGGAATCTCTCTAGTTCATT
CGGTTAGCAGGGGATGAATAGGCCGCCAAA|GGAGTCCAAGCACTCATTTAAAATGCGTCG
GGGCCGCTCTCTGCTCTTCTACACGCTTTT|AGGCCGCCAAAAAGGAATTGCGTACGACTA
AGGCGGTGGGGGATCCGATTTTTCTGTGGC|GTGAAGCAGGTTTGTGTTCATCACATCGTG
CGTCGCTCACGGTACGCTAAAACTTGATTA|ATAAAATCCGGTTAGCAGGACACTTGCCTT
ACCGGAGCACGAGGAGTCCAAGCACTCATT|ACTACCATACGAAATAAAATCCGGTTAGCA
CTCTACCTGTTATCCTCAAATAACATAGTT|TCTTTCCAGCACGGGCAGTCGACCGCTCTA
TACGAAATAAAATCCGGTTAGCAGGTGTTT|GTGCTCTACCTGTTATCCTCAAATAACATA
CGACCGCTCTACCATACGAAATAAAATCCG|ATACCATCGTGCCACCCGGGGTTAGTAGCA
AAATCCGGTTAGCAGAGGAGTAGAAATGTT|GCACGCGAAGGCGTTTTCACGCTTATTTCC
TACGAAATAAAATCCGGTTAGCAGAGAGGA|AGTCGACATTCCAATCAGGGAGGACGCTTG
GCTACGACAACGTGCGCACGCGAAGGCGTT|ATCCGGTTAGCAGAGAGGAAAACCACGGGA
TTTTCACGCTTATTTCCGGGGCCTTAATTC|GAGGGTTTGGCCCGAAGTACGGACTACCAT
GTAGAAATGTTTAGCGCAACGAAAACGAGC|CGCTTATTTCCGGGGCCTTAATTCTCAGCT
AGTGGGCCGTCGGTTTCTTTCCAGCACGGG|CTTCTACACGCTTTTCAATGAGCCCCCTAC
TAACGGCTTGCTGTCCTAGAAACTACCATA|AGCAGGAAGTCCTCACAGGGACCCTACCAT
ATCCGGTTAGCAGCTATGGGAAGCCTACCA|AATCCGGTTAGCAGGTGTTTCCTGTCCCTA
ATGACGTCCCTCCGAACCGAGATCCAGTCG|ATTAAGGGCTTAGGGGCGGAACGTGGCATC
AATAAAATCCGGTTAGCAGGGGCCGCTCTC|CGGTTAGCAGGGGATGAATAGGCCGCCAAA
GAGGAGTAGAAATGTTTAGCGCAACGAAAA|TTTCACGCTTATTTCCGGGGCCTTAATTCT
TCTCAGCTCACTACTACCATACGAAATAAA|ATACGAAATAAAATCCGGTTAGCAGACTGG
GACGCTTGGCCCATTCTCTCCACATCTTCC|TTGCCGCCACTAGAAGGCGGTGGGGGATCC
CTACCATACGAAATAAAATCCGGTTAGCAG|CGAGACCCTGCTTAACGATTTTCCTAGCAG
TCCTAGAAACTACCATACGAAATAAAATCC|CACAGGGACCCTACCATACGAAATAAAATC
CGGTTAGCAGATAAAATCCTACCATACGAA|TCATTACACCTGGCACGGCTTCAAAGACCA
GATTTTTCTGTGGCGCTACCATACGAAATA|TTCATCACATCGTGTCGAGACCCTGCTTAA
TGTTATCCTCAAATAACATAGTTGTGATTT|AGCACGGGCAGTCGACCGCTCTACCATACG
AAGTCCTCACAGGGACCCTACCATACGAAA|CGGTTAGCAGCGGTTAGCAGGTGGTGCTCT
TACGCTAAAACTTGATTAAGGGCTTAGGGG|TAGCAGGACACTTGCCTTCGAAAGTCCGAT
AATAAAATCCGGTTAGCAGAGGAGTAGAAA|GTGCGCACGCGAAGGCGTTTTCACGCTTAT
TTTTCTGTGGCGCTACCATACGAAATAAAA|ATCACATCGTGTCGAGACCCTGCTTAACGA
ACATTCCAATCAGGGAGGACGCTTGGCCCA|TTTATCCGAAGTTAGCATTGCCGCCACTAG
CCATACGAAATAAAATCCGGTTAGCAGACT|ATTACCGTTCTTAGCGTCGCTCACGGTACG
AGATCCAGTCGACATTCCAATCAGGGAGGA|AACGTGGCATCTTTATCCGAAGTTAGCATT
AAATCCGGTTAGCAGAGAGGAAAACCACGG|TCCAATCAGGGAGGACGCTTGGCCCATTCT
TAAAATCCGGTTAGCAGAGAGGAAAACCAC|ATTCCAATCAGGGAGGACGCTTGGCCCATT
TATGACGTCCCTCCGAACCGAGATCCAGTC|GATTAAGGGCTTAGGGGCGGAACGTGGCAT
ACGAAATAAAATCCGGTTAGCAGATAAAAT|GAATCTCTCTAGTTCATTACACCTGGCACG
ACGAAATAAAATCCGGTTAGCAGACTGGCT|CCGTTCTTAGCGTCGCTCACGGTACGCTAA
AAGGGCTTAGGGGCGGAACGTGGCATCTTT|TCGAAAGTCCGATAAAATGAATTCGTCCTT
GATTACCGTTCTTAGCGTCGCTCACGGTAC|GCGCTACCATACGAAATAAAATCCGGTTAG
AACCGGAGCACGAGGAGTCCAAGCACTCAT|TACTACCATACGAAATAAAATCCGGTTAGC
GGAGTAGAAATGTTTAGCGCAACGAAAACG|TCACGCTTATTTCCGGGGCCTTAATTCTCA
GCACGGGCAGTCGACCGCTCTACCATACGA|CCCCTACGACCATACCATCGTGCCACCCGG
TAGCAGATAAAATCCTACCATACGAAATAA|TACACCTGGCACGGCTTCAAAGACCAATAG
AAATCCTACCATACGAAATAAAATCCGGTT|CACGGCTTCAAAGACCAATAGCCGGCGACC
GTTAGCAGAGAGGAAAACCACGGGAGGGTT|AGGGAGGACGCTTGGCCCATTCTCTCCACA
TTAGTGCAAGGTCCAAAGGAATCTCTCTAG|CGAAATAAAATCCGGTTAGCAGGTATCAAG
TCCAAGCACTCATTTAAAATGCGTCGTTGT|AAATCCGGTTAGCAGTGCTCCTTACGGATC
AGTTGTGATTTAGTGCAAGGTCCAAAGGAA|TCTACCATACGAAATAAAATCCGGTTAGCA
CAAATAACATAGTTGTGATTTAGTGCAAGG|AGTCGACCGCTCTACCATACGAAATAAAAT
CCTACGACCATACCATCGTGCCACCCGGGG|GAAATAAAATCCGGTTAGCAGAGGAGTAGA
AATCCGGTTAGCAGCTATGGGAAGCCTACC|AAATCCGGTTAGCAGGTGTTTCCTGTCCCT
CCTACCATACGAACTACCATACGAAATAAA|ATTTAGTGCAAGGTCCAAAGGAATCTCTCT
TCTTTCCAGCACGGGCAGTCGACCGCTCTA|CAATGAGCCCCCTACGACCATACCATCGTG
AGGTCCAAAGGAATCTCTCTAGTTCATTAC|AATCCGGTTAGCAGGTATCAAGGATATCTA
GGTTAGCAGAGGAGTAGAAATGTTTAGCGC|GAAGGCGTTTTCACGCTTATTTCCGGGGCC
TAGCAGCGGTTAGCAGGTGGTGCTCTACCT|CCTTGAGAGTGGGCCGTCGGTTTCTTTCCA
CTACGACCATACCATCGTGCCACCCGGGGT|AAATAAAATCCGGTTAGCAGAGGAGTAGAA
AAATCCGGTTAGCAGGGGATGAATAGGCCG|CACGAGGAGTCCAAGCACTCATTTAAAATG
TAGCAGTGGCCCTGCTACCTACCATACGAA|GAAATAAAATCCGGTTAGCAGATAAAATCC
CGGTTAGCAGGTGGTGCTCTACCTGTTATC|GAGTGGGCCGTCGGTTTCTTTCCAGCACGG
TTCATTACACCTGGCACGGCTTCAAAGACC|GATATCTACCATACGAAATAAAATCCGGTT
TACCATCGTGCCACCCGGGGTTAGTAGCAT|CCGGTTAGCAGAGGAGTAGAAATGTTTAGC
TAGCAGGGGATGAATAGGCCGCCAAAAAGG|TCCAAGCACTCATTTAAAATGCGTCGTTGT
TACGAACTACCATACGAAATAAAATCCGGT|GCAAGGTCCAAAGGAATCTCTCTAGTTCAT
TCAGGGAGGACGCTTGGCCCATTCTCTCCA|AGTTAGCATTGCCGCCACTAGAAGGCGGTG
CGAACACGCTACGACAACGTGCGCACGCGA|AAATAAAATCCGGTTAGCAGAGAGGAAAAC
ACGAAATAAAATCCGGTTAGCAGGTATCAA|CCGGGGTTAGTAGCATCATGTATTAAGCTA
TAGGCCGCCAAAAAGGAATTGCGTACGACT|TAAAATGCGTCGTTGTTAGCCGGAACGAAC
CGAAATAAAATCCGGTTAGCAGGGGCCGCT|ATCCGGTTAGCAGGGGATGAATAGGCCGCC
ACGGGCAGTCGACCGCTCTACCATACGAAA|CCTACGACCATACCATCGTGCCACCCGGGG
AGGGGATGAATAGGCCGCCAAAAAGGAATT|AGCACTCATTTAAAATGCGTCGTTGTTAGC
ATACGAAATAAAATCCGGTTAGCAGGGGAT|TCAACCGGAGCACGAGGAGTCCAAGCACTC
AAAGGAATTGCGTACGACTAGCTACCATAC|GTTGTTAGCCGGAACGAACACGCTACGACA
CGCCAAAAAGGAATTGCGTACGACTAGCTA|TGCGTCGTTGTTAGCCGGAACGAACACGCT
ATCGTGCCACCCGGGGTTAGTAGCATCATG|TTAGCAGAGGAGTAGAAATGTTTAGCGCAA
CACGCTTTTCAATGAGCCCCCTACGACCAT|GTACGACTAGCTACCATACGAAATAAAATC
GCTACCATACGAAATAAAATCCGGTTAGCA|TCGAGACCCTGCTTAACGATTTTCCTAGCA
CCGCTCTCTGCTCTTCTACACGCTTTTCAA|CCGCCAAAAAGGAATTGCGTACGACTAGCT
TTTCCTGTCCCTACCATACGAACTACCATA|ATAGTTGTGATTTAGTGCAAGGTCCAAAGG
TACCATACGAAATAAAATCCGGTTAGCAGC|CTACCATACGAAATAAAATCCGGTTAGCAG
CGCTCACGGTACGCTAAAACTTGATTAAGG|AAATCCGGTTAGCAGGACACTTGCCTTCGA
AATCCGGTTAGCAGTGGCCCTGCTACCTAC|TACCATACGAAATAAAATCCGGTTAGCAGA
TACGAAATAAAATCCGGTTAGCAGCGGTTA|AGACCAATAGCCGGCGACCCTTGAGAGTGG
GAGGAGTCCAAGCACTCATTTAAAATGCGT|GAAATAAAATCCGGTTAGCAGTGCTCCTTA
GCATTGCCGCCACTAGAAGGCGGTGGGGGA|AGCAAGCGCGCGTTTTAGTGAAGCAGGTTT
ACCATACGAAATAAAATCCGGTTAGCAGCT|TACCATACGAAATAAAATCCGGTTAGCAGG
TTAGCGTCGCTCACGGTACGCTAAAACTTG|CGAAATAAAATCCGGTTAGCAGGACACTTG
GGTTAGCAGTGCTCCTTACGGATCTACCAT|TTTTATGACGTCCCTCCGAACCGAGATCCA
GGTTTCTTTCCAGCACGGGCAGTCGACCGC|TTTTCAATGAGCCCCCTACGACCATACCAT
GACTAGCTACCATACGAAATAAAATCCGGT|GAACACGCTACGACAACGTGCGCACGCGAA
AATCCGGTTAGCAGATAAAATCCTACCATA|TAGTTCATTACACCTGGCACGGCTTCAAAG
GGCAGTCGACCGCTCTACCATACGAAATAA|ACGACCATACCATCGTGCCACCCGGGGTTA
TTTCTTTCCAGCACGGGCAGTCGACCGCTC|TTCAATGAGCCCCCTACGACCATACCATCG
GAAATAAAATCCGGTTAGCAGGTATCAAGG|GGGGTTAGTAGCATCATGTATTAAGCTACC
CGCAACGAAAACGAGCTTCAACCGGAGCAC|GCCTTAATTCTCAGCTCACTACTACCATAC
TAAAATCCGGTTAGCAGAGGAGTAGAAATG|GCGCACGCGAAGGCGTTTTCACGCTTATTT
GTCGCTCACGGTACGCTAAAACTTGATTAA|TAAAATCCGGTTAGCAGGACACTTGCCTTC
CCGGTTAGCAGGGGATGAATAGGCCGCCAA|AGGAGTCCAAGCACTCATTTAAAATGCGTC
CATACGAAATAAAATCCGGTTAGCAGCTAT|CCATACGAAATAAAATCCGGTTAGCAGGTG
ATACGAAATAAAATCCGGTTAGCAGAGGAG|GACAACGTGCGCACGCGAAGGCGTTTTCAC
CCAAGCACTCATTTAAAATGCGTCGTTGTT|AATCCGGTTAGCAGTGCTCCTTACGGATCT
AGTTCATTACACCTGGCACGGCTTCAAAGA|AGGATATCTACCATACGAAATAAAATCCGG
TCAAGGATATCTACCATACGAAATAAAATC|GCTACCATACGAAATAAAATCCGGTTAGCA
ATTAAGCTACCATACGAAATAAAATCCGGT|GAAAACGAGCTTCAACCGGAGCACGAGGAG
GAATCTCTCTAGTTCATTACACCTGGCACG|GCAGGTATCAAGGATATCTACCATACGAAA
CACATCTTCCGGGGCTAATAAAGATTACCG|TGGGGGATCCGATTTTTCTGTGGCGCTACC
CATTGCCGCCACTAGAAGGCGGTGGGGGAT|GCAAGCGCGCGTTTTAGTGAAGCAGGTTTG
TAGCTACCATACGAAATAAAATCCGGTTAG|CACGCTACGACAACGTGCGCACGCGAAGGC
GGTATCAAGGATATCTACCATACGAAATAA|TTAAGCTACCATACGAAATAAAATCCGGTT
GAAATAAAATCCGGTTAGCAGACTGGCTAG|GTTCTTAGCGTCGCTCACGGTACGCTAAAA
ATCCGGTTAGCAGTGGCCCTGCTACCTACC|ACCATACGAAATAAAATCCGGTTAGCAGAT
TCTTTATCCGAAGTTAGCATTGCCGCCACT|TCCTTGGGCGTTCGGAAGCAAGCGCGCGTT
AACGTGGCATCTTTATCCGAAGTTAGCATT|ATGAATTCGTCCTTGGGCGTTCGGAAGCAA
AAAATCCTACCATACGAAATAAAATCCGGT|GCACGGCTTCAAAGACCAATAGCCGGCGAC
CTGGCTAGTTTTATGACGTCCCTCCGAACC|CGCTAAAACTTGATTAAGGGCTTAGGGGCG
GCGGTTAGCAGGTGGTGCTCTACCTGTTAT|AGAGTGGGCCGTCGGTTTCTTTCCAGCACG
AGCGATAGTAACGGCTTGCTGTCCTAGAAA|ATCCGGTTAGCAGGAAGTCCTCACAGGGAC
TCTCTGCTCTTCTACACGCTTTTCAATGAG|CAAAAAGGAATTGCGTACGACTAGCTACCA
TACGAAATAAAATCCGGTTAGCAGAGGAGT|ACAACGTGCGCACGCGAAGGCGTTTTCACG
CCTGTCCCTACCATACGAACTACCATACGA|GTTGTGATTTAGTGCAAGGTCCAAAGGAAT
TTTTATGACGTCCCTCCGAACCGAGATCCA|CTTGATTAAGGGCTTAGGGGCGGAACGTGG
CAGTGGCCCTGCTACCTACCATACGAAATA|ATAAAATCCGGTTAGCAGATAAAATCCTAC
CTACACGCTTTTCAATGAGCCCCCTACGAC|TGCGTACGACTAGCTACCATACGAAATAAA
CGGTACGCTAAAACTTGATTAAGGGCTTAG|GGTTAGCAGGACACTTGCCTTCGAAAGTCC
CGAACTACCATACGAAATAAAATCCGGTTA|AAGGTCCAAAGGAATCTCTCTAGTTCATTA
CTCTGCTCTTCTACACGCTTTTCAATGAGC|AAAAAGGAATTGCGTACGACTAGCTACCAT
TCGTTGTTAGCCGGAACGAACACGCTACGA|ACGGATCTACCATACGAAATAAAATCCGGT
AGCTACCATACGAAATAAAATCCGGTTAGC|ACGAGCTTCAACCGGAGCACGAGGAGTCCA
CGAGGAGTCCAAGCACTCATTTAAAATGCG|CGAAATAAAATCCGGTTAGCAGTGCTCCTT
GGATCTACCATACGAAATAAAATCCGGTTA|ACCGAGATCCAGTCGACATTCCAATCAGGG
TGCTCTACCTGTTATCCTCAAATAACATAG|TTTCTTTCCAGCACGGGCAGTCGACCGCTC
GTCGACCGCTCTACCATACGAAATAAAATC|CCATACCATCGTGCCACCCGGGGTTAGTAG
ATTTAAAATGCGTCGTTGTTAGCCGGAACG|GCAGTGCTCCTTACGGATCTACCATACGAA
AATAGGCCGCCAAAAAGGAATTGCGTACGA|TTTAAAATGCGTCGTTGTTAGCCGGAACGA
GGTTAGCAGGGGATGAATAGGCCGCCAAAA|GAGTCCAAGCACTCATTTAAAATGCGTCGT
AAATAAAATCCGGTTAGCAGAGAGGAAAAC|GACATTCCAATCAGGGAGGACGCTTGGCCC
TCTACCATACGAAATAAAATCCGGTTAGCA|CGTGCCACCCGGGGTTAGTAGCATCATGTA
TCGACATTCCAATCAGGGAGGACGCTTGGC|ATCTTTATCCGAAGTTAGCATTGCCGCCAC
TAAAATCCGGTTAGCAGATAAAATCCTACC|CTCTAGTTCATTACACCTGGCACGGCTTCA
GGACGCTTGGCCCATTCTCTCCACATCTTC|ATTGCCGCCACTAGAAGGCGGTGGGGGATC
GGAGGGTTTGGCCCGAAGTACGGACTACCA|TCTCCACATCTTCCGGGGCTAATAAAGATT
GCACGGCTTCAAAGACCAATAGCCGGCGAC|CGAAATAAAATCCGGTTAGCAGGGGCCGCT
CTACCATACGAAATAAAATCCGGTTAGCAG|TCCCTACCATACGAACTACCATACGAAATA
CGGCGACCCTTGAGAGTGGGCCGTCGGTTT|GGCCGCTCTCTGCTCTTCTACACGCTTTTC
GTGCTCCTTACGGATCTACCATACGAAATA|CGTCCCTCCGAACCGAGATCCAGTCGACAT
AAGGCGTTTTCACGCTTATTTCCGGGGCCT|CCACGGGAGGGTTTGGCCCGAAGTACGGAC
TTAGCAGGTGGTGCTCTACCTGTTATCCTC|TGGGCCGTCGGTTTCTTTCCAGCACGGGCA
GGGTTTGGCCCGAAGTACGGACTACCATAC|CCACATCTTCCGGGGCTAATAAAGATTACC
AGCAGGAAGTCCTCACAGGGACCCTACCAT|AAAATCCGGTTAGCAGCGGTTAGCAGGTGG
AACCGAGATCCAGTCGACATTCCAATCAGG|GGCGGAACGTGGCATCTTTATCCGAAGTTA
TAGCATCATGTATTAAGCTACCATACGAAA|TTTAGCGCAACGAAAACGAGCTTCAACCGG
CAGGTGTTTCCTGTCCCTACCATACGAACT|AATAACATAGTTGTGATTTAGTGCAAGGTC
CTAAAACTTGATTAAGGGCTTAGGGGCGGA|AGGACACTTGCCTTCGAAAGTCCGATAAAA
ACGAAATAAAATCCGGTTAGCAGGAAGTCC|AATCCTACCATACGAAATAAAATCCGGTTA
TTTAGCGCAACGAAAACGAGCTTCAACCGG|CCGGGGCCTTAATTCTCAGCTCACTACTAC
AAATCCGGTTAGCAGGTATCAAGGATATCT|AGTAGCATCATGTATTAAGCTACCATACGA
CATGTATTAAGCTACCATACGAAATAAAAT|GCAACGAAAACGAGCTTCAACCGGAGCACG
AGCAGTGCTCCTTACGGATCTACCATACGA|ATGACGTCCCTCCGAACCGAGATCCAGTCG
CGACAACGTGCGCACGCGAAGGCGTTTTCA|GGTTAGCAGAGAGGAAAACCACGGGAGGGT
TGGCTAGTTTTATGACGTCCCTCCGAACCG|GCTAAAACTTGATTAAGGGCTTAGGGGCGG
ATACGAAATAAAATCCGGTTAGCAGACTGG|TACCGTTCTTAGCGTCGCTCACGGTACGCT
TTAGCGCAACGAAAACGAGCTTCAACCGGA|CGGGGCCTTAATTCTCAGCTCACTACTACC
GAGAGTGGGCCGTCGGTTTCTTTCCAGCAC|GCTCTTCTACACGCTTTTCAATGAGCCCCC
CCTCACAGGGACCCTACCATACGAAATAAA|TAGCAGCGGTTAGCAGGTGGTGCTCTACCT
ACCGCTCTACCATACGAAATAAAATCCGGT|ACCATCGTGCCACCCGGGGTTAGTAGCATC
TCCGGTTAGCAGGGGATGAATAGGCCGCCA|GAGGAGTCCAAGCACTCATTTAAAATGCGT
AGGCCGCCAAAAAGGAATTGCGTACGACTA|AAAATGCGTCGTTGTTAGCCGGAACGAACA
AATCCGGTTAGCAGACTGGCTAGTTTTATG|GCGTCGCTCACGGTACGCTAAAACTTGATT
TTCTCTCCACATCTTCCGGGGCTAATAAAG|AAGGCGGTGGGGGATCCGATTTTTCTGTGG
AGGGCTTAGGGGCGGAACGTGGCATCTTTA|CGAAAGTCCGATAAAATGAATTCGTCCTTG
TAATAAAGATTACCGTTCTTAGCGTCGCTC|TTCTGTGGCGCTACCATACGAAATAAAATC
ATACGAAATAAAATCCGGTTAGCAGATAAA|AGGAATCTCTCTAGTTCATTACACCTGGCA
ACCCTACCATACGAAATAAAATCCGGTTAG|TAGCAGGTGGTGCTCTACCTGTTATCCTCA
TCATGTATTAAGCTACCATACGAAATAAAA|CGCAACGAAAACGAGCTTCAACCGGAGCAC
CGAAGTTAGCATTGCCGCCACTAGAAGGCG|CGTTCGGAAGCAAGCGCGCGTTTTAGTGAA
ATACGAAATAAAATCCGGTTAGCAGGGGCC|AAAATCCGGTTAGCAGGGGATGAATAGGCC
GTGGGGGATCCGATTTTTCTGTGGCGCTAC|GCAGGTTTGTGTTCATCACATCGTGTCGAG
GAACCGAGATCCAGTCGACATTCCAATCAG|GGGCGGAACGTGGCATCTTTATCCGAAGTT
TAGAAACTACCATACGAAATAAAATCCGGT|AGGGACCCTACCATACGAAATAAAATCCGG
GGGAGGACGCTTGGCCCATTCTCTCCACAT|TAGCATTGCCGCCACTAGAAGGCGGTGGGG
CTACCATACGAAATAAAATCCGGTTAGCAG|AAGATTACCGTTCTTAGCGTCGCTCACGGT
AGGCGTTTTCACGCTTATTTCCGGGGCCTT|CACGGGAGGGTTTGGCCCGAAGTACGGACT
GGCTAATAAAGATTACCGTTCTTAGCGTCG|TTTTTCTGTGGCGCTACCATACGAAATAAA
TACCTGTTATCCTCAAATAACATAGTTGTG|TTCCAGCACGGGCAGTCGACCGCTCTACCA
GTTAGCAGGAAGTCCTCACAGGGACCCTAC|AATAAAATCCGGTTAGCAGCGGTTAGCAGG
CCGGTTAGCAGAGGAGTAGAAATGTTTAGC|GCGAAGGCGTTTTCACGCTTATTTCCGGGG
AATCCGGTTAGCAGGGGATGAATAGGCCGC|ACGAGGAGTCCAAGCACTCATTTAAAATGC
CTACCATACGAAATAAAATCCGGTTAGCAG|CAGGTGGTGCTCTACCTGTTATCCTCAAAT
ATTCTCTCCACATCTTCCGGGGCTAATAAA|GAAGGCGGTGGGGGATCCGATTTTTCTGTG
GACTGGCTAGTTTTATGACGTCCCTCCGAA|TACGCTAAAACTTGATTAAGGGCTTAGGGG
AGGGTTTGGCCCGAAGTACGGACTACCATA|TCCACATCTTCCGGGGCTAATAAAGATTAC
CACTACTACCATACGAAATAAAATCCGGTT|TAAAATCCGGTTAGCAGACTGGCTAGTTTT
GTTTTATGACGTCCCTCCGAACCGAGATCC|ACTTGATTAAGGGCTTAGGGGCGGAACGTG
TGGGCCGTCGGTTTCTTTCCAGCACGGGCA|TCTACACGCTTTTCAATGAGCCCCCTACGA
TAAAATCCGGTTAGCAGACTGGCTAGTTTT|TTAGCGTCGCTCACGGTACGCTAAAACTTG
GTGTTTCCTGTCCCTACCATACGAACTACC|AACATAGTTGTGATTTAGTGCAAGGTCCAA
CCATACGAAATAAAATCCGGTTAGCAGAGA|TCCAGTCGACATTCCAATCAGGGAGGACGC
GCCGCCAAAAAGGAATTGCGTACGACTAGC|AATGCGTCGTTGTTAGCCGGAACGAACACG
GTTTCTTTCCAGCACGGGCAGTCGACCGCT|TTTCAATGAGCCCCCTACGACCATACCATC
CTTGAGAGTGGGCCGTCGGTTTCTTTCCAG|TCTGCTCTTCTACACGCTTTTCAATGAGCC
GAATTGCGTACGACTAGCTACCATACGAAA|TTAGCCGGAACGAACACGCTACGACAACGT
ACCCTTGAGAGTGGGCCGTCGGTTTCTTTC|CTCTCTGCTCTTCTACACGCTTTTCAATGA
AGCAGGTGTTTCCTGTCCCTACCATACGAA|CAAATAACATAGTTGTGATTTAGTGCAAGG
CTGGCACGGCTTCAAAGACCAATAGCCGGC|ATACGAAATAAAATCCGGTTAGCAGGGGCC
CGAGCTTCAACCGGAGCACGAGGAGTCCAA|CAGCTCACTACTACCATACGAAATAAAATC
TTATGACGTCCCTCCGAACCGAGATCCAGT|TGATTAAGGGCTTAGGGGCGGAACGTGGCA
AGTAGCATCATGTATTAAGCTACCATACGA|TGTTTAGCGCAACGAAAACGAGCTTCAACC
ACCATACGAAATAAAATCCGGTTAGCAGAG|TACGACAACGTGCGCACGCGAAGGCGTTTT
GCCTTAATTCTCAGCTCACTACTACCATAC|GGACTACCATACGAAATAAAATCCGGTTAG
TTCTCAGCTCACTACTACCATACGAAATAA|CATACGAAATAAAATCCGGTTAGCAGACTG
ACCATACGAAATAAAATCCGGTTAGCAGAG|ATCCAGTCGACATTCCAATCAGGGAGGACG
CCGGAACGAACACGCTACGACAACGTGCGC|CATACGAAATAAAATCCGGTTAGCAGAGAG
TAGTTGTGATTTAGTGCAAGGTCCAAAGGA|CTCTACCATACGAAATAAAATCCGGTTAGC
TACCATACGAAATAAAATCCGGTTAGCAGG|AAATAAAATCCGGTTAGCAGGGGATGAATA
TGGCACGGCTTCAAAGACCAATAGCCGGCG|TACGAAATAAAATCCGGTTAGCAGGGGCCG
ACGTCCCTCCGAACCGAGATCCAGTCGACA|AAGGGCTTAGGGGCGGAACGTGGCATCTTT
GACATTCCAATCAGGGAGGACGCTTGGCCC|CTTTATCCGAAGTTAGCATTGCCGCCACTA
TTGTGATTTAGTGCAAGGTCCAAAGGAATC|TACCATACGAAATAAAATCCGGTTAGCAGG
GAGGGTTTGGCCCGAAGTACGGACTACCAT|CTCCACATCTTCCGGGGCTAATAAAGATTA
TAGCAGGTATCAAGGATATCTACCATACGA|ATGTATTAAGCTACCATACGAAATAAAATC
GCTATGGGAAGCCTACCATACGAAATAAAA|AGGTGTTTCCTGTCCCTACCATACGAACTA
GTGCCACCCGGGGTTAGTAGCATCATGTAT|GCAGAGGAGTAGAAATGTTTAGCGCAACGA
GGCCTTAATTCTCAGCTCACTACTACCATA|CGGACTACCATACGAAATAAAATCCGGTTA
GCTACCTACCATACGAAATAAAATCCGGTT|GTTAGCAGATAAAATCCTACCATACGAAAT
AGCAGCTATGGGAAGCCTACCATACGAAAT|TAGCAGGTGTTTCCTGTCCCTACCATACGA
CGATAGTAACGGCTTGCTGTCCTAGAAACT|CCGGTTAGCAGGAAGTCCTCACAGGGACCC
TGTTAGCCGGAACGAACACGCTACGACAAC|ATCTACCATACGAAATAAAATCCGGTTAGC
CTCTACCATACGAAATAAAATCCGGTTAGC|TCGTGCCACCCGGGGTTAGTAGCATCATGT
GCAGGTATCAAGGATATCTACCATACGAAA|GTATTAAGCTACCATACGAAATAAAATCCG
GGCGGAACGTGGCATCTTTATCCGAAGTTA|ATAAAATGAATTCGTCCTTGGGCGTTCGGA
TGCGCACGCGAAGGCGTTTTCACGCTTATT|GAGAGGAAAACCACGGGAGGGTTTGGCCCG
ACACGCTACGACAACGTGCGCACGCGAAGG|TAAAATCCGGTTAGCAGAGAGGAAAACCAC
TGCTCCTTACGGATCTACCATACGAAATAA|GTCCCTCCGAACCGAGATCCAGTCGACATT
AATCCGGTTAGCAGCGGTTAGCAGGTGGTG|CCGGCGACCCTTGAGAGTGGGCCGTCGGTT
CCTCAAATAACATAGTTGTGATTTAGTGCA|GGCAGTCGACCGCTCTACCATACGAAATAA
GCTTTTCAATGAGCCCCCTACGACCATACC|CGACTAGCTACCATACGAAATAAAATCCGG
CATCGTGCCACCCGGGGTTAGTAGCATCAT|GTTAGCAGAGGAGTAGAAATGTTTAGCGCA
ACGAAATAAAATCCGGTTAGCAGGACACTT|CTGCTTAACGATTTTCCTAGCAGACACTTG
ACGCTACGACAACGTGCGCACGCGAAGGCG|AAATCCGGTTAGCAGAGAGGAAAACCACGG
TTACCGTTCTTAGCGTCGCTCACGGTACGC|GCTACCATACGAAATAAAATCCGGTTAGCA
CATACGAAATAAAATCCGGTTAGCAGGTAT|CACCCGGGGTTAGTAGCATCATGTATTAAG
GTCGTTGTTAGCCGGAACGAACACGCTACG|TACGGATCTACCATACGAAATAAAATCCGG
CATACGAAATAAAATCCGGTTAGCAGAGGA|CGACAACGTGCGCACGCGAAGGCGTTTTCA
TTGATTAAGGGCTTAGGGGCGGAACGTGGC|TTGCCTTCGAAAGTCCGATAAAATGAATTC
CTACCATACGAAATAAAATCCGGTTAGCAG|TCCAAAGGAATCTCTCTAGTTCATTACACC
ATTGCCGCCACTAGAAGGCGGTGGGGGATC|CAAGCGCGCGTTTTAGTGAAGCAGGTTTGT
TACGAAATAAAATCCGGTTAGCAGGTATCA|CCCGGGGTTAGTAGCATCATGTATTAAGCT
GAAGGCGTTTTCACGCTTATTTCCGGGGCC|ACCACGGGAGGGTTTGGCCCGAAGTACGGA
CCCTACGACCATACCATCGTGCCACCCGGG|CGAAATAAAATCCGGTTAGCAGAGGAGTAG
TAGAAGGCGGTGGGGGATCCGATTTTTCTG|TTTAGTGAAGCAGGTTTGTGTTCATCACAT
ACCATACGAAATAAAATCCGGTTAGCAGTG|CCTACCATACGAACTACCATACGAAATAAA
CTTCTACACGCTTTTCAATGAGCCCCCTAC|AATTGCGTACGACTAGCTACCATACGAAAT
TATCTACCATACGAAATAAAATCCGGTTAG|TACGAAATAAAATCCGGTTAGCAGGGGATG
TGAGAGTGGGCCGTCGGTTTCTTTCCAGCA|TGCTCTTCTACACGCTTTTCAATGAGCCCC
ACCATCGTGCCACCCGGGGTTAGTAGCATC|CGGTTAGCAGAGGAGTAGAAATGTTTAGCG
GTTATCCTCAAATAACATAGTTGTGATTTA|GCACGGGCAGTCGACCGCTCTACCATACGA
CCATACGAACTACCATACGAAATAAAATCC|AGTGCAAGGTCCAAAGGAATCTCTCTAGTT
CGCTTTTCAATGAGCCCCCTACGACCATAC|ACGACTAGCTACCATACGAAATAAAATCCG
ACTAGAAGGCGGTGGGGGATCCGATTTTTC|GTTTTAGTGAAGCAGGTTTGTGTTCATCAC
AATCCTACCATACGAAATAAAATCCGGTTA|ACGGCTTCAAAGACCAATAGCCGGCGACCC
CAGTGCTCCTTACGGATCTACCATACGAAA|GACGTCCCTCCGAACCGAGATCCAGTCGAC
CACGGCTTCAAAGACCAATAGCCGGCGACC|GAAATAAAATCCGGTTAGCAGGGGCCGCTC
GAGGAAAACCACGGGAGGGTTTGGCCCGAA|GCTTGGCCCATTCTCTCCACATCTTCCGGG
AAGCACTCATTTAAAATGCGTCGTTGTTAG|TCCGGTTAGCAGTGCTCCTTACGGATCTAC
GCGGAACGTGGCATCTTTATCCGAAGTTAG|TAAAATGAATTCGTCCTTGGGCGTTCGGAA
GGCTAGTTTTATGACGTCCCTCCGAACCGA|CTAAAACTTGATTAAGGGCTTAGGGGCGGA
TGGCATCTTTATCCGAAGTTAGCATTGCCG|ATTCGTCCTTGGGCGTTCGGAAGCAAGCGC
GAAATGTTTAGCGCAACGAAAACGAGCTTC|TTATTTCCGGGGCCTTAATTCTCAGCTCAC
TCCGGTTAGCAGAGGAGTAGAAATGTTTAG|CGCGAAGGCGTTTTCACGCTTATTTCCGGG
CTCTCTGCTCTTCTACACGCTTTTCAATGA|CCAAAAAGGAATTGCGTACGACTAGCTACC
ACGCTTGGCCCATTCTCTCCACATCTTCCG|TGCCGCCACTAGAAGGCGGTGGGGGATCCG
GCTAGTTTTATGACGTCCCTCCGAACCGAG|TAAAACTTGATTAAGGGCTTAGGGGCGGAA
ACCTGGCACGGCTTCAAAGACCAATAGCCG|CCATACGAAATAAAATCCGGTTAGCAGGGG
TCTACCATACGAAATAAAATCCGGTTAGCA|GAGATCCAGTCGACATTCCAATCAGGGAGG
CAGGTATCAAGGATATCTACCATACGAAAT|TATTAAGCTACCATACGAAATAAAATCCGG
TAGCAGGGGCCGCTCTCTGCTCTTCTACAC|ATGAATAGGCCGCCAAAAAGGAATTGCGTA
TGTATTAAGCTACCATACGAAATAAAATCC|AACGAAAACGAGCTTCAACCGGAGCACGAG
GCTCACTACTACCATACGAAATAAAATCCG|AAATAAAATCCGGTTAGCAGACTGGCTAGT
GGTTAGTAGCATCATGTATTAAGCTACCAT|GAAATGTTTAGCGCAACGAAAACGAGCTTC
CGAAATAAAATCCGGTTAGCAGGACACTTG|TGCTTAACGATTTTCCTAGCAGACACTTGC
CTCAGCTCACTACTACCATACGAAATAAAA|TACGAAATAAAATCCGGTTAGCAGACTGGC
ACGACAACGTGCGCACGCGAAGGCGTTTTC|CGGTTAGCAGAGAGGAAAACCACGGGAGGG
TTCCAATCAGGGAGGACGCTTGGCCCATTC|ATCCGAAGTTAGCATTGCCGCCACTAGAAG
AAGGAATTGCGTACGACTAGCTACCATACG|TTGTTAGCCGGAACGAACACGCTACGACAA
CCTACCATACGAAATAAAATCCGGTTAGCA|GCAGATAAAATCCTACCATACGAAATAAAA
ACTACCATACGAAATAAAATCCGGTTAGCA|GTCCAAAGGAATCTCTCTAGTTCATTACAC
GGTACGCTAAAACTTGATTAAGGGCTTAGG|GTTAGCAGGACACTTGCCTTCGAAAGTCCG
TACGGACTACCATACGAAATAAAATCCGGT|CTAATAAAGATTACCGTTCTTAGCGTCGCT
CGGTTAGCAGGTGTTTCCTGTCCCTACCAT|ATCCTCAAATAACATAGTTGTGATTTAGTG
TCAATGAGCCCCCTACGACCATACCATCGT|AGCTACCATACGAAATAAAATCCGGTTAGC
CCTACCATACGAAATAAAATCCGGTTAGCA|GTCCCTACCATACGAACTACCATACGAAAT
ATCCAGTCGACATTCCAATCAGGGAGGACG|CGTGGCATCTTTATCCGAAGTTAGCATTGC
AGGTATCAAGGATATCTACCATACGAAATA|ATTAAGCTACCATACGAAATAAAATCCGGT
TCCGGTTAGCAGGTATCAAGGATATCTACC|AGCATCATGTATTAAGCTACCATACGAAAT
ACGACCATACCATCGTGCCACCCGGGGTTA|ATAAAATCCGGTTAGCAGAGGAGTAGAAAT
GGGCGGAACGTGGCATCTTTATCCGAAGTT|GATAAAATGAATTCGTCCTTGGGCGTTCGG
CATACGAAATAAAATCCGGTTAGCAGTGCT|GTTAGCAGACTGGCTAGTTTTATGACGTCC
CCACCCGGGGTTAGTAGCATCATGTATTAA|GAGGAGTAGAAATGTTTAGCGCAACGAAAA
TTAGCAGCGGTTAGCAGGTGGTGCTCTACC|CCCTTGAGAGTGGGCCGTCGGTTTCTTTCC
ACGTGCGCACGCGAAGGCGTTTTCACGCTT|GCAGAGAGGAAAACCACGGGAGGGTTTGGC
GGCTTGCTGTCCTAGAAACTACCATACGAA|GGAAGTCCTCACAGGGACCCTACCATACGA
CGGACTACCATACGAAATAAAATCCGGTTA|AATAAAGATTACCGTTCTTAGCGTCGCTCA
ATCCGGTTAGCAGGTATCAAGGATATCTAC|TAGCATCATGTATTAAGCTACCATACGAAA
AGCAGTGGCCCTGCTACCTACCATACGAAA|AAATAAAATCCGGTTAGCAGATAAAATCCT
GGAAGTCCTCACAGGGACCCTACCATACGA|TCCGGTTAGCAGCGGTTAGCAGGTGGTGCT
AGCGGTTAGCAGGTGGTGCTCTACCTGTTA|GAGAGTGGGCCGTCGGTTTCTTTCCAGCAC
CAAAGACCAATAGCCGGCGACCCTTGAGAG|ATCCGGTTAGCAGGGGCCGCTCTCTGCTCT
GCAGGTGTTTCCTGTCCCTACCATACGAAC|AAATAACATAGTTGTGATTTAGTGCAAGGT
TTGAGAGTGGGCCGTCGGTTTCTTTCCAGC|CTGCTCTTCTACACGCTTTTCAATGAGCCC
ATCTTTATCCGAAGTTAGCATTGCCGCCAC|GTCCTTGGGCGTTCGGAAGCAAGCGCGCGT
CGGAACGAACACGCTACGACAACGTGCGCA|ATACGAAATAAAATCCGGTTAGCAGAGAGG
AATAAAATCCGGTTAGCAGATAAAATCCTA|CTCTCTAGTTCATTACACCTGGCACGGCTT
GGCCCATTCTCTCCACATCTTCCGGGGCTA|CACTAGAAGGCGGTGGGGGATCCGATTTTT
TTAGCAGTGGCCCTGCTACCTACCATACGA|CGAAATAAAATCCGGTTAGCAGATAAAATC
AATCCGGTTAGCAGGTGTTTCCTGTCCCTA|TGTTATCCTCAAATAACATAGTTGTGATTT
CAGGTGGTGCTCTACCTGTTATCCTCAAAT|CCGTCGGTTTCTTTCCAGCACGGGCAGTCG
GCAGCTATGGGAAGCCTACCATACGAAATA|AGCAGGTGTTTCCTGTCCCTACCATACGAA
AGCAGGGGCCGCTCTCTGCTCTTCTACACG|TGAATAGGCCGCCAAAAAGGAATTGCGTAC
TCCTACCATACGAAATAAAATCCGGTTAGC|GGCTTCAAAGACCAATAGCCGGCGACCCTT
CGGGAGGGTTTGGCCCGAAGTACGGACTAC|TCTCTCCACATCTTCCGGGGCTAATAAAGA
AGAAACTACCATACGAAATAAAATCCGGTT|GGGACCCTACCATACGAAATAAAATCCGGT
CGGGCAGTCGACCGCTCTACCATACGAAAT|CTACGACCATACCATCGTGCCACCCGGGGT
ACCATACGAAATAAAATCCGGTTAGCAGGT|GCCACCCGGGGTTAGTAGCATCATGTATTA
GCCAAAAAGGAATTGCGTACGACTAGCTAC|GCGTCGTTGTTAGCCGGAACGAACACGCTA
CGCTCTACCATACGAAATAAAATCCGGTTA|CATCGTGCCACCCGGGGTTAGTAGCATCAT
CACTCATTTAAAATGCGTCGTTGTTAGCCG|GGTTAGCAGTGCTCCTTACGGATCTACCAT
ATAAAATCCGGTTAGCAGGAAGTCCTCACA|TACCATACGAAATAAAATCCGGTTAGCAGC
CCAGCACGGGCAGTCGACCGCTCTACCATA|AGCCCCCTACGACCATACCATCGTGCCACC
CGAACCGAGATCCAGTCGACATTCCAATCA|GGGGCGGAACGTGGCATCTTTATCCGAAGT
GTTAGCATTGCCGCCACTAGAAGGCGGTGG|CGGAAGCAAGCGCGCGTTTTAGTGAAGCAG
TCCGGGGCCTTAATTCTCAGCTCACTACTA|AAGTACGGACTACCATACGAAATAAAATCC
ATCCGGTTAGCAGTGCTCCTTACGGATCTA|CTAGTTTTATGACGTCCCTCCGAACCGAGA
CGAAATAAAATCCGGTTAGCAGAGAGGAAA|TCGACATTCCAATCAGGGAGGACGCTTGGC
CGGCTTCAAAGACCAATAGCCGGCGACCCT|AATAAAATCCGGTTAGCAGGGGCCGCTCTC
AGTTTTATGACGTCCCTCCGAACCGAGATC|AACTTGATTAAGGGCTTAGGGGCGGAACGT
CGCCACTAGAAGGCGGTGGGGGATCCGATT|GCGCGTTTTAGTGAAGCAGGTTTGTGTTCA
ACGAGCTTCAACCGGAGCACGAGGAGTCCA|TCAGCTCACTACTACCATACGAAATAAAAT
AATAACATAGTTGTGATTTAGTGCAAGGTC|TCGACCGCTCTACCATACGAAATAAAATCC
ACGGCTTCAAAGACCAATAGCCGGCGACCC|AAATAAAATCCGGTTAGCAGGGGCCGCTCT
TAGTTTTATGACGTCCCTCCGAACCGAGAT|AAACTTGATTAAGGGCTTAGGGGCGGAACG
GGAATCTCTCTAGTTCATTACACCTGGCAC|AGCAGGTATCAAGGATATCTACCATACGAA
GCCCTGCTACCTACCATACGAAATAAAATC|ATCCGGTTAGCAGATAAAATCCTACCATAC
TACCATACGAAATAAAATCCGGTTAGCAGA|CCAAAGGAATCTCTCTAGTTCATTACACCT
AGCATTGCCGCCACTAGAAGGCGGTGGGGG|AAGCAAGCGCGCGTTTTAGTGAAGCAGGTT
TTAGCAGGTATCAAGGATATCTACCATACG|CATGTATTAAGCTACCATACGAAATAAAAT
CTGTCCCTACCATACGAACTACCATACGAA|TTGTGATTTAGTGCAAGGTCCAAAGGAATC
CATTACACCTGGCACGGCTTCAAAGACCAA|TATCTACCATACGAAATAAAATCCGGTTAG
GCTTCAAAGACCAATAGCCGGCGACCCTTG|TAAAATCCGGTTAGCAGGGGCCGCTCTCTG
GGGCAGTCGACCGCTCTACCATACGAAATA|TACGACCATACCATCGTGCCACCCGGGGTT
CCTGTTATCCTCAAATAACATAGTTGTGAT|CCAGCACGGGCAGTCGACCGCTCTACCATA
CTTGGCCCATTCTCTCCACATCTTCCGGGG|CGCCACTAGAAGGCGGTGGGGGATCCGATT
GAAGCCTACCATACGAAATAAAATCCGGTT|TCCTGTCCCTACCATACGAACTACCATACG
GTACGGACTACCATACGAAATAAAATCCGG|GCTAATAAAGATTACCGTTCTTAGCGTCGC
TTAAAATGCGTCGTTGTTAGCCGGAACGAA|AGTGCTCCTTACGGATCTACCATACGAAAT
CCAAAAAGGAATTGCGTACGACTAGCTACC|CGTCGTTGTTAGCCGGAACGAACACGCTAC
TCCAGCACGGGCAGTCGACCGCTCTACCAT|GAGCCCCCTACGACCATACCATCGTGCCAC
TTCACGCTTATTTCCGGGGCCTTAATTCTC|GGGTTTGGCCCGAAGTACGGACTACCATAC
GGCCGCTCTCTGCTCTTCTACACGCTTTTC|GGCCGCCAAAAAGGAATTGCGTACGACTAG
TACCATACGAAATAAAATCCGGTTAGCAGC|TTCAAAGACCAATAGCCGGCGACCCTTGAG
CCATTCTCTCCACATCTTCCGGGGCTAATA|TAGAAGGCGGTGGGGGATCCGATTTTTCTG
TGATTAAGGGCTTAGGGGCGGAACGTGGCA|TGCCTTCGAAAGTCCGATAAAATGAATTCG
GGAAAACCACGGGAGGGTTTGGCCCGAAGT|TTGGCCCATTCTCTCCACATCTTCCGGGGC
GTGGCCCTGCTACCTACCATACGAAATAAA|AAAATCCGGTTAGCAGATAAAATCCTACCA
GATCCGATTTTTCTGTGGCGCTACCATACG|TTGTGTTCATCACATCGTGTCGAGACCCTG
CAGCGGTTAGCAGGTGGTGCTCTACCTGTT|TGAGAGTGGGCCGTCGGTTTCTTTCCAGCA
CATACGAAATAAAATCCGGTTAGCAGATAA|AAGGAATCTCTCTAGTTCATTACACCTGGC
ATCCGGTTAGCAGAGAGGAAAACCACGGGA|CAATCAGGGAGGACGCTTGGCCCATTCTCT
CTACCATACGAAATAAAATCCGGTTAGCAG|GAGCTTCAACCGGAGCACGAGGAGTCCAAG
GGTGGTGCTCTACCTGTTATCCTCAAATAA|GTCGGTTTCTTTCCAGCACGGGCAGTCGAC
TTATCCGAAGTTAGCATTGCCGCCACTAGA|TTGGGCGTTCGGAAGCAAGCGCGCGTTTTA
AAAATCCGGTTAGCAGGACACTTGCCTTCG|ACGATTTTCCTAGCAGACACTTGCTCAGCT
TTAGCAGGACACTTGCCTTCGAAAGTCCGA|CTAGCAGACACTTGCTCAGCTCGACCAGGC
GAACTACCATACGAAATAAAATCCGGTTAG|AGGTCCAAAGGAATCTCTCTAGTTCATTAC
CTCTTCTACACGCTTTTCAATGAGCCCCCT|GGAATTGCGTACGACTAGCTACCATACGAA
TAGTTCATTACACCTGGCACGGCTTCAAAG|AAGGATATCTACCATACGAAATAAAATCCG
ACGAAATAAAATCCGGTTAGCAGAGAGGAA|GTCGACATTCCAATCAGGGAGGACGCTTGG
CTGTCCTAGAAACTACCATACGAAATAAAA|CCTCACAGGGACCCTACCATACGAAATAAA
TAAAGATTACCGTTCTTAGCGTCGCTCACG|TGTGGCGCTACCATACGAAATAAAATCCGG
ATCCGGTTAGCAGATAAAATCCTACCATAC|AGTTCATTACACCTGGCACGGCTTCAAAGA
AAATGCGTCGTTGTTAGCCGGAACGAACAC|GCTCCTTACGGATCTACCATACGAAATAAA
ACACGCTTTTCAATGAGCCCCCTACGACCA|CGTACGACTAGCTACCATACGAAATAAAAT
AAGTACGGACTACCATACGAAATAAAATCC|GGGCTAATAAAGATTACCGTTCTTAGCGTC
GCATCTTTATCCGAAGTTAGCATTGCCGCC|TCGTCCTTGGGCGTTCGGAAGCAAGCGCGC
AAAATCCGGTTAGCAGCGGTTAGCAGGTGG|AGCCGGCGACCCTTGAGAGTGGGCCGTCGG
CCGGAGCACGAGGAGTCCAAGCACTCATTT|CTACCATACGAAATAAAATCCGGTTAGCAG
CCGGTTAGCAGCTATGGGAAGCCTACCATA|TCCGGTTAGCAGGTGTTTCCTGTCCCTACC
CATACGAAATAAAATCCGGTTAGCAGAGAG|CCAGTCGACATTCCAATCAGGGAGGACGCT
AGCGTCGCTCACGGTACGCTAAAACTTGAT|AAATAAAATCCGGTTAGCAGGACACTTGCC
CCAATCAGGGAGGACGCTTGGCCCATTCTC|CCGAAGTTAGCATTGCCGCCACTAGAAGGC
GACCAATAGCCGGCGACCCTTGAGAGTGGG|GGTTAGCAGGGGCCGCTCTCTGCTCTTCTA
GCCACTAGAAGGCGGTGGGGGATCCGATTT|CGCGTTTTAGTGAAGCAGGTTTGTGTTCAT
GCAGACTGGCTAGTTTTATGACGTCCCTCC|CGGTACGCTAAAACTTGATTAAGGGCTTAG
GACCCTTGAGAGTGGGCCGTCGGTTTCTTT|GCTCTCTGCTCTTCTACACGCTTTTCAATG
TCCGGTTAGCAGATAAAATCCTACCATACG|GTTCATTACACCTGGCACGGCTTCAAAGAC
CGGGGCTAATAAAGATTACCGTTCTTAGCG|CGATTTTTCTGTGGCGCTACCATACGAAAT
ACTTGATTAAGGGCTTAGGGGCGGAACGTG|ACTTGCCTTCGAAAGTCCGATAAAATGAAT
CGGTTAGCAGCTATGGGAAGCCTACCATAC|CCGGTTAGCAGGTGTTTCCTGTCCCTACCA
AATCCGGTTAGCAGGACACTTGCCTTCGAA|GATTTTCCTAGCAGACACTTGCTCAGCTCG
CCGGTTAGCAGTGCTCCTTACGGATCTACC|AGTTTTATGACGTCCCTCCGAACCGAGATC
ACTAGCTACCATACGAAATAAAATCCGGTT|AACACGCTACGACAACGTGCGCACGCGAAG
GGCGACCCTTGAGAGTGGGCCGTCGGTTTC|GCCGCTCTCTGCTCTTCTACACGCTTTTCA
GTGCTCTACCTGTTATCCTCAAATAACATA|GTTTCTTTCCAGCACGGGCAGTCGACCGCT
GATTAAGGGCTTAGGGGCGGAACGTGGCAT|GCCTTCGAAAGTCCGATAAAATGAATTCGT
TGGCGCTACCATACGAAATAAAATCCGGTT|CGTGTCGAGACCCTGCTTAACGATTTTCCT
TTTCCGGGGCCTTAATTCTCAGCTCACTAC|CGAAGTACGGACTACCATACGAAATAAAAT
ATCCGATTTTTCTGTGGCGCTACCATACGA|TGTGTTCATCACATCGTGTCGAGACCCTGC
CGTGCGCACGCGAAGGCGTTTTCACGCTTA|CAGAGAGGAAAACCACGGGAGGGTTTGGCC
CCGGTTAGCAGGGGCCGCTCTCTGCTCTTC|AGGGGATGAATAGGCCGCCAAAAAGGAATT
CAGTCGACCGCTCTACCATACGAAATAAAA|GACCATACCATCGTGCCACCCGGGGTTAGT
TACCATACGAAATAAAATCCGGTTAGCAGT|CCGGTTAGCAGACTGGCTAGTTTTATGACG
AAAATCCGGTTAGCAGGGGCCGCTCTCTGC|TTAGCAGGGGATGAATAGGCCGCCAAAAAG
AAATCCGGTTAGCAGGACACTTGCCTTCGA|CGATTTTCCTAGCAGACACTTGCTCAGCTC
GCGCTACCATACGAAATAAAATCCGGTTAG|TGTCGAGACCCTGCTTAACGATTTTCCTAG
GCCCGAAGTACGGACTACCATACGAAATAA|TTCCGGGGCTAATAAAGATTACCGTTCTTA
ATAAAATCCGGTTAGCAGATAAAATCCTAC|TCTCTAGTTCATTACACCTGGCACGGCTTC
CGAAATAAAATCCGGTTAGCAGTGGCCCTG|ATACGAACTACCATACGAAATAAAATCCGG
AAATAAAATCCGGTTAGCAGGTATCAAGGA|GGGTTAGTAGCATCATGTATTAAGCTACCA
CGGTTAGCAGAGGAGTAGAAATGTTTAGCG|CGAAGGCGTTTTCACGCTTATTTCCGGGGC
AGGATATCTACCATACGAAATAAAATCCGG|ACCATACGAAATAAAATCCGGTTAGCAGGG
CTTAGGGGCGGAACGTGGCATCTTTATCCG|AGTCCGATAAAATGAATTCGTCCTTGGGCG
AGTAGAAATGTTTAGCGCAACGAAAACGAG|ACGCTTATTTCCGGGGCCTTAATTCTCAGC
TACGAAATAAAATCCGGTTAGCAGATAAAA|GGAATCTCTCTAGTTCATTACACCTGGCAC
CGACTAGCTACCATACGAAATAAAATCCGG|CGAACACGCTACGACAACGTGCGCACGCGA
CAAGGTCCAAAGGAATCTCTCTAGTTCATT|AAAATCCGGTTAGCAGGTATCAAGGATATC
CTCTCTAGTTCATTACACCTGGCACGGCTT|GTATCAAGGATATCTACCATACGAAATAAA
CACCTGGCACGGCTTCAAAGACCAATAGCC|ACCATACGAAATAAAATCCGGTTAGCAGGG
CGAAATAAAATCCGGTTAGCAGGAAGTCCT|ATCCTACCATACGAAATAAAATCCGGTTAG
TACGAAATAAAATCCGGTTAGCAGTGGCCC|CCATACGAACTACCATACGAAATAAAATCC
CCCTACCATACGAACTACCATACGAAATAA|GATTTAGTGCAAGGTCCAAAGGAATCTCTC
AAGGTCCAAAGGAATCTCTCTAGTTCATTA|AAATCCGGTTAGCAGGTATCAAGGATATCT
CGCTCTCTGCTCTTCTACACGCTTTTCAAT|CGCCAAAAAGGAATTGCGTACGACTAGCTA
TAGCAGAGGAGTAGAAATGTTTAGCGCAAC|GGCGTTTTCACGCTTATTTCCGGGGCCTTA
CGAAAACGAGCTTCAACCGGAGCACGAGGA|AATTCTCAGCTCACTACTACCATACGAAAT
GCAGATAAAATCCTACCATACGAAATAAAA|CACCTGGCACGGCTTCAAAGACCAATAGCC
TAAAATCCGGTTAGCAGGTATCAAGGATAT|TTAGTAGCATCATGTATTAAGCTACCATAC
CAGATAAAATCCTACCATACGAAATAAAAT|ACCTGGCACGGCTTCAAAGACCAATAGCCG
ATAAAATCCGGTTAGCAGGTGTTTCCTGTC|TACCTGTTATCCTCAAATAACATAGTTGTG
TTCAAAGACCAATAGCCGGCGACCCTTGAG|AAATCCGGTTAGCAGGGGCCGCTCTCTGCT
ATCTACCATACGAAATAAAATCCGGTTAGC|ACGAAATAAAATCCGGTTAGCAGGGGATGA
CCATACGAAATAAAATCCGGTTAGCAGCTA|ACCATACGAAATAAAATCCGGTTAGCAGGT
AAATAAAATCCGGTTAGCAGTGCTCCTTAC|AGACTGGCTAGTTTTATGACGTCCCTCCGA
ACCGTTCTTAGCGTCGCTCACGGTACGCTA|TACCATACGAAATAAAATCCGGTTAGCAGG
AATGAGCCCCCTACGACCATACCATCGTGC|CTACCATACGAAATAAAATCCGGTTAGCAG
AAACGAGCTTCAACCGGAGCACGAGGAGTC|TCTCAGCTCACTACTACCATACGAAATAAA
GAATAGGCCGCCAAAAAGGAATTGCGTACG|ATTTAAAATGCGTCGTTGTTAGCCGGAACG
CTTGATTAAGGGCTTAGGGGCGGAACGTGG|CTTGCCTTCGAAAGTCCGATAAAATGAATT
CACTAGAAGGCGGTGGGGGATCCGATTTTT|CGTTTTAGTGAAGCAGGTTTGTGTTCATCA
TCATTTAAAATGCGTCGTTGTTAGCCGGAA|TAGCAGTGCTCCTTACGGATCTACCATACG
GGTTAGCAGCTATGGGAAGCCTACCATACG|CGGTTAGCAGGTGTTTCCTGTCCCTACCAT
AATAAAATCCGGTTAGCAGTGCTCCTTACG|GACTGGCTAGTTTTATGACGTCCCTCCGAA
TTTATGACGTCCCTCCGAACCGAGATCCAG|TTGATTAAGGGCTTAGGGGCGGAACGTGGC
AAATAAAATCCGGTTAGCAGCTATGGGAAG|GAAATAAAATCCGGTTAGCAGGTGTTTCCT
GCAGAGGAGTAGAAATGTTTAGCGCAACGA|CGTTTTCACGCTTATTTCCGGGGCCTTAAT
ATGAGCCCCCTACGACCATACCATCGTGCC|TACCATACGAAATAAAATCCGGTTAGCAGA
GGCACGGCTTCAAAGACCAATAGCCGGCGA|ACGAAATAAAATCCGGTTAGCAGGGGCCGC
ATGCGTCGTTGTTAGCCGGAACGAACACGC|TCCTTACGGATCTACCATACGAAATAAAAT
GACCCTACCATACGAAATAAAATCCGGTTA|TTAGCAGGTGGTGCTCTACCTGTTATCCTC
AAAAAGGAATTGCGTACGACTAGCTACCAT|TCGTTGTTAGCCGGAACGAACACGCTACGA
GCACGAGGAGTCCAAGCACTCATTTAAAAT|ATACGAAATAAAATCCGGTTAGCAGTGCTC
TTGCTGTCCTAGAAACTACCATACGAAATA|AGTCCTCACAGGGACCCTACCATACGAAAT
GGAATTGCGTACGACTAGCTACCATACGAA|GTTAGCCGGAACGAACACGCTACGACAACG
GCTCTCTGCTCTTCTACACGCTTTTCAATG|GCCAAAAAGGAATTGCGTACGACTAGCTAC
ATTTAGTGCAAGGTCCAAAGGAATCTCTCT|TACGAAATAAAATCCGGTTAGCAGGTATCA
AAAACCACGGGAGGGTTTGGCCCGAAGTAC|GGCCCATTCTCTCCACATCTTCCGGGGCTA
GAAATAAAATCCGGTTAGCAGAGAGGAAAA|CGACATTCCAATCAGGGAGGACGCTTGGCC
TAAAATCCGGTTAGCAGGACACTTGCCTTC|AACGATTTTCCTAGCAGACACTTGCTCAGC
AGTACGGACTACCATACGAAATAAAATCCG|GGCTAATAAAGATTACCGTTCTTAGCGTCG
CGAAATAAAATCCGGTTAGCAGGTGTTTCC|GCTCTACCTGTTATCCTCAAATAACATAGT
GGGAAGCCTACCATACGAAATAAAATCCGG|TTTCCTGTCCCTACCATACGAACTACCATA
AGCTTCAACCGGAGCACGAGGAGTCCAAGC|GCTCACTACTACCATACGAAATAAAATCCG
CTTAGCGTCGCTCACGGTACGCTAAAACTT|ACGAAATAAAATCCGGTTAGCAGGACACTT
CTTAATTCTCAGCTCACTACTACCATACGA|ACTACCATACGAAATAAAATCCGGTTAGCA
TCCGAACCGAGATCCAGTCGACATTCCAAT|TAGGGGCGGAACGTGGCATCTTTATCCGAA
GAAGGCGGTGGGGGATCCGATTTTTCTGTG|TAGTGAAGCAGGTTTGTGTTCATCACATCG
GGAGCACGAGGAGTCCAAGCACTCATTTAA|ACCATACGAAATAAAATCCGGTTAGCAGTG
TACGAAATAAAATCCGGTTAGCAGCTATGG|ATACGAAATAAAATCCGGTTAGCAGGTGTT
CCTACCATACGAAATAAAATCCGGTTAGCA|GCAGGTGGTGCTCTACCTGTTATCCTCAAA
TAGTGCAAGGTCCAAAGGAATCTCTCTAGT|GAAATAAAATCCGGTTAGCAGGTATCAAGG
ACCATACGAAATAAAATCCGGTTAGCAGTG|CGGTTAGCAGACTGGCTAGTTTTATGACGT
CCGGTTAGCAGATAAAATCCTACCATACGA|TTCATTACACCTGGCACGGCTTCAAAGACC
TTTAAAATGCGTCGTTGTTAGCCGGAACGA|CAGTGCTCCTTACGGATCTACCATACGAAA
TCCTCAAATAACATAGTTGTGATTTAGTGC|GGGCAGTCGACCGCTCTACCATACGAAATA
CCGGTTAGCAGGACACTTGCCTTCGAAAGT|TTTCCTAGCAGACACTTGCTCAGCTCGACC
GAGAGGAAAACCACGGGAGGGTTTGGCCCG|ACGCTTGGCCCATTCTCTCCACATCTTCCG
TGGGAAGCCTACCATACGAAATAAAATCCG|GTTTCCTGTCCCTACCATACGAACTACCAT
AAAATCCGGTTAGCAGATAAAATCCTACCA|TCTAGTTCATTACACCTGGCACGGCTTCAA
AAGGATATCTACCATACGAAATAAAATCCG|TACCATACGAAATAAAATCCGGTTAGCAGG
CACGCTTATTTCCGGGGCCTTAATTCTCAG|GTTTGGCCCGAAGTACGGACTACCATACGA
TTCCGGGGCCTTAATTCTCAGCTCACTACT|GAAGTACGGACTACCATACGAAATAAAATC
CGAAATAAAATCCGGTTAGCAGACTGGCTA|CGTTCTTAGCGTCGCTCACGGTACGCTAAA
AAAATCCGGTTAGCAGGTGTTTCCTGTCCC|CCTGTTATCCTCAAATAACATAGTTGTGAT
TTAGCAGATAAAATCCTACCATACGAAATA|TTACACCTGGCACGGCTTCAAAGACCAATA
CAAGCACTCATTTAAAATGCGTCGTTGTTA|ATCCGGTTAGCAGTGCTCCTTACGGATCTA
CCGGTTAGCAGCGGTTAGCAGGTGGTGCTC|GCGACCCTTGAGAGTGGGCCGTCGGTTTCT
GCAGTGCTCCTTACGGATCTACCATACGAA|TGACGTCCCTCCGAACCGAGATCCAGTCGA
CATCATGTATTAAGCTACCATACGAAATAA|AGCGCAACGAAAACGAGCTTCAACCGGAGC
TTCCGGGGCTAATAAAGATTACCGTTCTTA|ATCCGATTTTTCTGTGGCGCTACCATACGA
ATTTCCGGGGCCTTAATTCTCAGCTCACTA|CCGAAGTACGGACTACCATACGAAATAAAA
CTTTATCCGAAGTTAGCATTGCCGCCACTA|CCTTGGGCGTTCGGAAGCAAGCGCGCGTTT
GAAATAAAATCCGGTTAGCAGGGGATGAAT|CCGGAGCACGAGGAGTCCAAGCACTCATTT
GGGGTTAGTAGCATCATGTATTAAGCTACC|TAGAAATGTTTAGCGCAACGAAAACGAGCT
GCAGCGGTTAGCAGGTGGTGCTCTACCTGT|TTGAGAGTGGGCCGTCGGTTTCTTTCCAGC
GCGGTGGGGGATCCGATTTTTCTGTGGCGC|GAAGCAGGTTTGTGTTCATCACATCGTGTC
ATATCTACCATACGAAATAAAATCCGGTTA|ATACGAAATAAAATCCGGTTAGCAGGGGAT
GCTTAGGGGCGGAACGTGGCATCTTTATCC|AAGTCCGATAAAATGAATTCGTCCTTGGGC
ATAAAATCCGGTTAGCAGGACACTTGCCTT|TAACGATTTTCCTAGCAGACACTTGCTCAG
TATTTCCGGGGCCTTAATTCTCAGCTCACT|CCCGAAGTACGGACTACCATACGAAATAAA
GTTAGTAGCATCATGTATTAAGCTACCATA|AAATGTTTAGCGCAACGAAAACGAGCTTCA
GGATGAATAGGCCGCCAAAAAGGAATTGCG|ACTCATTTAAAATGCGTCGTTGTTAGCCGG
AATCCGGTTAGCAGAGGAGTAGAAATGTTT|CACGCGAAGGCGTTTTCACGCTTATTTCCG
CATACGAACTACCATACGAAATAAAATCCG|GTGCAAGGTCCAAAGGAATCTCTCTAGTTC
AACTACCATACGAAATAAAATCCGGTTAGC|ACCCTACCATACGAAATAAAATCCGGTTAG
AACTTGATTAAGGGCTTAGGGGCGGAACGT|CACTTGCCTTCGAAAGTCCGATAAAATGAA
AGACTGGCTAGTTTTATGACGTCCCTCCGA|GTACGCTAAAACTTGATTAAGGGCTTAGGG
ACGAAATAAAATCCGGTTAGCAGTGGCCCT|CATACGAACTACCATACGAAATAAAATCCG
TAGCAGAGAGGAAAACCACGGGAGGGTTTG|GGAGGACGCTTGGCCCATTCTCTCCACATC
AGGAGTAGAAATGTTTAGCGCAACGAAAAC|TTCACGCTTATTTCCGGGGCCTTAATTCTC
CTTGCTGTCCTAGAAACTACCATACGAAAT|AAGTCCTCACAGGGACCCTACCATACGAAA
ATAAAATCCGGTTAGCAGAGAGGAAAACCA|CATTCCAATCAGGGAGGACGCTTGGCCCAT
CGCTAAAACTTGATTAAGGGCTTAGGGGCG|GCAGGACACTTGCCTTCGAAAGTCCGATAA
TGCTACCTACCATACGAAATAAAATCCGGT|GGTTAGCAGATAAAATCCTACCATACGAAA
CCCTGCTACCTACCATACGAAATAAAATCC|TCCGGTTAGCAGATAAAATCCTACCATACG
CGACCCTTGAGAGTGGGCCGTCGGTTTCTT|CGCTCTCTGCTCTTCTACACGCTTTTCAAT
ATTACACCTGGCACGGCTTCAAAGACCAAT|ATCTACCATACGAAATAAAATCCGGTTAGC
TCTACCTGTTATCCTCAAATAACATAGTTG|CTTTCCAGCACGGGCAGTCGACCGCTCTAC
GGGATCCGATTTTTCTGTGGCGCTACCATA|GTTTGTGTTCATCACATCGTGTCGAGACCC
CTACCTACCATACGAAATAAAATCCGGTTA|TTAGCAGATAAAATCCTACCATACGAAATA
TACGACAACGTGCGCACGCGAAGGCGTTTT|CCGGTTAGCAGAGAGGAAAACCACGGGAGG
GCTCTTCTACACGCTTTTCAATGAGCCCCC|AGGAATTGCGTACGACTAGCTACCATACGA
GCATCATGTATTAAGCTACCATACGAAATA|TAGCGCAACGAAAACGAGCTTCAACCGGAG
GGTTAGCAGGTGTTTCCTGTCCCTACCATA|TCCTCAAATAACATAGTTGTGATTTAGTGC
TATCCGAAGTTAGCATTGCCGCCACTAGAA|TGGGCGTTCGGAAGCAAGCGCGCGTTTTAG
CCACTAGAAGGCGGTGGGGGATCCGATTTT|GCGTTTTAGTGAAGCAGGTTTGTGTTCATC
CCAAAGGAATCTCTCTAGTTCATTACACCT|CGGTTAGCAGGTATCAAGGATATCTACCAT
GAAATAAAATCCGGTTAGCAGGTGTTTCCT|CTCTACCTGTTATCCTCAAATAACATAGTT
GATTTAGTGCAAGGTCCAAAGGAATCTCTC|ATACGAAATAAAATCCGGTTAGCAGGTATC
CGGTTAGCAGACTGGCTAGTTTTATGACGT|CGCTCACGGTACGCTAAAACTTGATTAAGG
ATAGCCGGCGACCCTTGAGAGTGGGCCGTC|GCAGGGGCCGCTCTCTGCTCTTCTACACGC
AAGATTACCGTTCTTAGCGTCGCTCACGGT|TGGCGCTACCATACGAAATAAAATCCGGTT
GGTGGGGGATCCGATTTTTCTGTGGCGCTA|AGCAGGTTTGTGTTCATCACATCGTGTCGA
TCACGGTACGCTAAAACTTGATTAAGGGCT|TCCGGTTAGCAGGACACTTGCCTTCGAAAG
GGGGCCTTAATTCTCAGCTCACTACTACCA|TACGGACTACCATACGAAATAAAATCCGGT
ATAGTAACGGCTTGCTGTCCTAGAAACTAC|GGTTAGCAGGAAGTCCTCACAGGGACCCTA
GGTTAGCAGATAAAATCCTACCATACGAAA|CATTACACCTGGCACGGCTTCAAAGACCAA
GGATATCTACCATACGAAATAAAATCCGGT|CCATACGAAATAAAATCCGGTTAGCAGGGG
CTACCATACGAAATAAAATCCGGTTAGCAG|AGATCCAGTCGACATTCCAATCAGGGAGGA
GGGAGGGTTTGGCCCGAAGTACGGACTACC|CTCTCCACATCTTCCGGGGCTAATAAAGAT
TGTCCTAGAAACTACCATACGAAATAAAAT|CTCACAGGGACCCTACCATACGAAATAAAA
CCGCCACTAGAAGGCGGTGGGGGATCCGAT|CGCGCGTTTTAGTGAAGCAGGTTTGTGTTC
TGTGATTTAGTGCAAGGTCCAAAGGAATCT|ACCATACGAAATAAAATCCGGTTAGCAGGT
GAAATAAAATCCGGTTAGCAGGAAGTCCTC|TCCTACCATACGAAATAAAATCCGGTTAGC
TTCAACCGGAGCACGAGGAGTCCAAGCACT|CACTACTACCATACGAAATAAAATCCGGTT
ACAACGTGCGCACGCGAAGGCGTTTTCACG|TTAGCAGAGAGGAAAACCACGGGAGGGTTT
GCCTACCATACGAAATAAAATCCGGTTAGC|TGTCCCTACCATACGAACTACCATACGAAA
GGTTAGCAGGACACTTGCCTTCGAAAGTCC|TCCTAGCAGACACTTGCTCAGCTCGACCAG
GCAGTGGCCCTGCTACCTACCATACGAAAT|AATAAAATCCGGTTAGCAGATAAAATCCTA
GTCCTAGAAACTACCATACGAAATAAAATC|TCACAGGGACCCTACCATACGAAATAAAAT
AGACCAATAGCCGGCGACCCTTGAGAGTGG|CGGTTAGCAGGGGCCGCTCTCTGCTCTTCT
TAGCGCAACGAAAACGAGCTTCAACCGGAG|GGGGCCTTAATTCTCAGCTCACTACTACCA
TCCGGTTAGCAGACTGGCTAGTTTTATGAC|GTCGCTCACGGTACGCTAAAACTTGATTAA
CACAGGGACCCTACCATACGAAATAAAATC|CAGCGGTTAGCAGGTGGTGCTCTACCTGTT
GCCGCCACTAGAAGGCGGTGGGGGATCCGA|GCGCGCGTTTTAGTGAAGCAGGTTTGTGTT
ACCATACGAAATAAAATCCGGTTAGCAGGA|AGACCCTGCTTAACGATTTTCCTAGCAGAC
GGCCGCCAAAAAGGAATTGCGTACGACTAG|AAATGCGTCGTTGTTAGCCGGAACGAACAC
TACCATACGAAATAAAATCCGGTTAGCAGG|AGGTGGTGCTCTACCTGTTATCCTCAAATA
AGCAGATAAAATCCTACCATACGAAATAAA|ACACCTGGCACGGCTTCAAAGACCAATAGC
ATAGTTGTGATTTAGTGCAAGGTCCAAAGG|GCTCTACCATACGAAATAAAATCCGGTTAG
CTACCATACGAAATAAAATCCGGTTAGCAG|GTGCCACCCGGGGTTAGTAGCATCATGTAT
TTTCCAGCACGGGCAGTCGACCGCTCTACC|ATGAGCCCCCTACGACCATACCATCGTGCC
TATTAAGCTACCATACGAAATAAAATCCGG|CGAAAACGAGCTTCAACCGGAGCACGAGGA
AGTTAGCATTGCCGCCACTAGAAGGCGGTG|TCGGAAGCAAGCGCGCGTTTTAGTGAAGCA
CCGTCGGTTTCTTTCCAGCACGGGCAGTCG|CACGCTTTTCAATGAGCCCCCTACGACCAT
AGCCGGCGACCCTTGAGAGTGGGCCGTCGG|AGGGGCCGCTCTCTGCTCTTCTACACGCTT
CGTGGCATCTTTATCCGAAGTTAGCATTGC|GAATTCGTCCTTGGGCGTTCGGAAGCAAGC
ACGAAATAAAATCCGGTTAGCAGCTATGGG|TACGAAATAAAATCCGGTTAGCAGGTGTTT
GATGAATAGGCCGCCAAAAAGGAATTGCGT|CTCATTTAAAATGCGTCGTTGTTAGCCGGA
ACGAACACGCTACGACAACGTGCGCACGCG|GAAATAAAATCCGGTTAGCAGAGAGGAAAA
TGTGGCGCTACCATACGAAATAAAATCCGG|ATCGTGTCGAGACCCTGCTTAACGATTTTC
TCTCTCTAGTTCATTACACCTGGCACGGCT|GGTATCAAGGATATCTACCATACGAAATAA
TACGAAATAAAATCCGGTTAGCAGGACACT|CCTGCTTAACGATTTTCCTAGCAGACACTT
CCCGAAGTACGGACTACCATACGAAATAAA|TCCGGGGCTAATAAAGATTACCGTTCTTAG
CACCCGGGGTTAGTAGCATCATGTATTAAG|AGGAGTAGAAATGTTTAGCGCAACGAAAAC
CTGCTCTTCTACACGCTTTTCAATGAGCCC|AAAGGAATTGCGTACGACTAGCTACCATAC
GTCCCTCCGAACCGAGATCCAGTCGACATT|GGGCTTAGGGGCGGAACGTGGCATCTTTAT
TCCCTCCGAACCGAGATCCAGTCGACATTC|GGCTTAGGGGCGGAACGTGGCATCTTTATC
AATTCTCAGCTCACTACTACCATACGAAAT|ACCATACGAAATAAAATCCGGTTAGCAGAC
AGTGCTCCTTACGGATCTACCATACGAAAT|ACGTCCCTCCGAACCGAGATCCAGTCGACA
TAGCAGTGCTCCTTACGGATCTACCATACG|TATGACGTCCCTCCGAACCGAGATCCAGTC
CGTCGGTTTCTTTCCAGCACGGGCAGTCGA|ACGCTTTTCAATGAGCCCCCTACGACCATA
ACCATACGAAATAAAATCCGGTTAGCAGGA|GATAAAATCCTACCATACGAAATAAAATCC
ACGCGAAGGCGTTTTCACGCTTATTTCCGG|GAAAACCACGGGAGGGTTTGGCCCGAAGTA
AGCAGGTATCAAGGATATCTACCATACGAA|TGTATTAAGCTACCATACGAAATAAAATCC
ACGAAATAAAATCCGGTTAGCAGGGGATGA|AACCGGAGCACGAGGAGTCCAAGCACTCAT
TAGCCGGCGACCCTTGAGAGTGGGCCGTCG|CAGGGGCCGCTCTCTGCTCTTCTACACGCT
TGGCCCATTCTCTCCACATCTTCCGGGGCT|CCACTAGAAGGCGGTGGGGGATCCGATTTT
AAATCCGGTTAGCAGCGGTTAGCAGGTGGT|GCCGGCGACCCTTGAGAGTGGGCCGTCGGT
GTACGCTAAAACTTGATTAAGGGCTTAGGG|TTAGCAGGACACTTGCCTTCGAAAGTCCGA
AGGAATCTCTCTAGTTCATTACACCTGGCA|TAGCAGGTATCAAGGATATCTACCATACGA
TACGAAATAAAATCCGGTTAGCAGGGGATG|CAACCGGAGCACGAGGAGTCCAAGCACTCA
TAAAATCCGGTTAGCAGTGGCCCTGCTACC|AACTACCATACGAAATAAAATCCGGTTAGC
GCAACGAAAACGAGCTTCAACCGGAGCACG|CCTTAATTCTCAGCTCACTACTACCATACG
AAATAAAATCCGGTTAGCAGTGGCCCTGCT|ACGAACTACCATACGAAATAAAATCCGGTT
AAATAAAATCCGGTTAGCAGCGGTTAGCAG|CAATAGCCGGCGACCCTTGAGAGTGGGCCG
TGCGTCGTTGTTAGCCGGAACGAACACGCT|CCTTACGGATCTACCATACGAAATAAAATC
TACGAAATAAAATCCGGTTAGCAGGGGCCG|AAATCCGGTTAGCAGGGGATGAATAGGCCG
TAGAAATGTTTAGCGCAACGAAAACGAGCT|GCTTATTTCCGGGGCCTTAATTCTCAGCTC
AATGCGTCGTTGTTAGCCGGAACGAACACG|CTCCTTACGGATCTACCATACGAAATAAAA
GGCGCTACCATACGAAATAAAATCCGGTTA|GTGTCGAGACCCTGCTTAACGATTTTCCTA
ACCATACGAAATAAAATCCGGTTAGCAGGT|GGTGGTGCTCTACCTGTTATCCTCAAATAA
GGGACCCTACCATACGAAATAAAATCCGGT|GGTTAGCAGGTGGTGCTCTACCTGTTATCC
TACACCTGGCACGGCTTCAAAGACCAATAG|CTACCATACGAAATAAAATCCGGTTAGCAG
GGAAGCCTACCATACGAAATAAAATCCGGT|TTCCTGTCCCTACCATACGAACTACCATAC
AGAAGGCGGTGGGGGATCCGATTTTTCTGT|TTAGTGAAGCAGGTTTGTGTTCATCACATC
TCAAAGACCAATAGCCGGCGACCCTTGAGA|AATCCGGTTAGCAGGGGCCGCTCTCTGCTC
ACACCTGGCACGGCTTCAAAGACCAATAGC|TACCATACGAAATAAAATCCGGTTAGCAGG
TCTCTCCACATCTTCCGGGGCTAATAAAGA|AGGCGGTGGGGGATCCGATTTTTCTGTGGC
GTGGTGCTCTACCTGTTATCCTCAAATAAC|TCGGTTTCTTTCCAGCACGGGCAGTCGACC
TACCTACCATACGAAATAAAATCCGGTTAG|TAGCAGATAAAATCCTACCATACGAAATAA
AAAATCCGGTTAGCAGAGGAGTAGAAATGT|CGCACGCGAAGGCGTTTTCACGCTTATTTC
GGTTAGCAGTGGCCCTGCTACCTACCATAC|TACGAAATAAAATCCGGTTAGCAGATAAAA
TGTCCCTACCATACGAACTACCATACGAAA|TGTGATTTAGTGCAAGGTCCAAAGGAATCT
TCGTGCCACCCGGGGTTAGTAGCATCATGT|TAGCAGAGGAGTAGAAATGTTTAGCGCAAC
CTACCATACGAAATAAAATCCGGTTAGCAG|CAGATAAAATCCTACCATACGAAATAAAAT
CCATCGTGCCACCCGGGGTTAGTAGCATCA|GGTTAGCAGAGGAGTAGAAATGTTTAGCGC
AATCCGGTTAGCAGGGGCCGCTCTCTGCTC|AGCAGGGGATGAATAGGCCGCCAAAAAGGA
TCAGCTCACTACTACCATACGAAATAAAAT|ACGAAATAAAATCCGGTTAGCAGACTGGCT
TCTACCATACGAAATAAAATCCGGTTAGCA|CGAAATAAAATCCGGTTAGCAGGGGATGAA
GGGGATCCGATTTTTCTGTGGCGCTACCAT|GGTTTGTGTTCATCACATCGTGTCGAGACC
TCCGGTTAGCAGTGCTCCTTACGGATCTAC|TAGTTTTATGACGTCCCTCCGAACCGAGAT
TGCTCTTCTACACGCTTTTCAATGAGCCCC|AAGGAATTGCGTACGACTAGCTACCATACG
GGGGGATCCGATTTTTCTGTGGCGCTACCA|AGGTTTGTGTTCATCACATCGTGTCGAGAC
GCACGCGAAGGCGTTTTCACGCTTATTTCC|AGGAAAACCACGGGAGGGTTTGGCCCGAAG
TACGAAATAAAATCCGGTTAGCAGGAAGTC|AAATCCTACCATACGAAATAAAATCCGGTT
GGTGTTTCCTGTCCCTACCATACGAACTAC|TAACATAGTTGTGATTTAGTGCAAGGTCCA
GGGCCGTCGGTTTCTTTCCAGCACGGGCAG|CTACACGCTTTTCAATGAGCCCCCTACGAC
AAATCCGGTTAGCAGGGGCCGCTCTCTGCT|TAGCAGGGGATGAATAGGCCGCCAAAAAGG
CTTCCGGGGCTAATAAAGATTACCGTTCTT|GATCCGATTTTTCTGTGGCGCTACCATACG
ACCATACGAAATAAAATCCGGTTAGCAGAC|GATTACCGTTCTTAGCGTCGCTCACGGTAC
CAGCACGGGCAGTCGACCGCTCTACCATAC|GCCCCCTACGACCATACCATCGTGCCACCC
CAGGGAGGACGCTTGGCCCATTCTCTCCAC|GTTAGCATTGCCGCCACTAGAAGGCGGTGG
GGTTAGCAGGTATCAAGGATATCTACCATA|ATCATGTATTAAGCTACCATACGAAATAAA
GCCCATTCTCTCCACATCTTCCGGGGCTAA|ACTAGAAGGCGGTGGGGGATCCGATTTTTC
CAGGGACCCTACCATACGAAATAAAATCCG|GCGGTTAGCAGGTGGTGCTCTACCTGTTAT
CATCTTCCGGGGCTAATAAAGATTACCGTT|GGGGATCCGATTTTTCTGTGGCGCTACCAT
CGCTTATTTCCGGGGCCTTAATTCTCAGCT|TTGGCCCGAAGTACGGACTACCATACGAAA
CAAAAAGGAATTGCGTACGACTAGCTACCA|GTCGTTGTTAGCCGGAACGAACACGCTACG
TGGCCCTGCTACCTACCATACGAAATAAAA|AAATCCGGTTAGCAGATAAAATCCTACCAT
AGCCGGAACGAACACGCTACGACAACGTGC|ACCATACGAAATAAAATCCGGTTAGCAGAG
TTAGCAGGGGCCGCTCTCTGCTCTTCTACA|GATGAATAGGCCGCCAAAAAGGAATTGCGT
ACCATACGAAATAAAATCCGGTTAGCAGGG|GCTTCAACCGGAGCACGAGGAGTCCAAGCA
ATACGAAATAAAATCCGGTTAGCAGCGGTT|AAGACCAATAGCCGGCGACCCTTGAGAGTG
GCAGAGAGGAAAACCACGGGAGGGTTTGGC|AGGACGCTTGGCCCATTCTCTCCACATCTT
ACCATACGAAATAAAATCCGGTTAGCAGGG|AATAAAATCCGGTTAGCAGGGGATGAATAG
AGCAGGGGATGAATAGGCCGCCAAAAAGGA|CCAAGCACTCATTTAAAATGCGTCGTTGTT
GTATCAAGGATATCTACCATACGAAATAAA|TAAGCTACCATACGAAATAAAATCCGGTTA
TTAAGGGCTTAGGGGCGGAACGTGGCATCT|CTTCGAAAGTCCGATAAAATGAATTCGTCC
AAATAAAATCCGGTTAGCAGGGGATGAATA|CGGAGCACGAGGAGTCCAAGCACTCATTTA
GCAGGTGGTGCTCTACCTGTTATCCTCAAA|GCCGTCGGTTTCTTTCCAGCACGGGCAGTC
GGAGGACGCTTGGCCCATTCTCTCCACATC|AGCATTGCCGCCACTAGAAGGCGGTGGGGG
AATAAAATCCGGTTAGCAGAGAGGAAAACC|ACATTCCAATCAGGGAGGACGCTTGGCCCA
CTCATTTAAAATGCGTCGTTGTTAGCCGGA|TTAGCAGTGCTCCTTACGGATCTACCATAC
AATCCGGTTAGCAGGAAGTCCTCACAGGGA|ATACGAAATAAAATCCGGTTAGCAGCGGTT
TTAGCAGACTGGCTAGTTTTATGACGTCCC|TCACGGTACGCTAAAACTTGATTAAGGGCT
GATAGTAACGGCTTGCTGTCCTAGAAACTA|CGGTTAGCAGGAAGTCCTCACAGGGACCCT
TGAATAGGCCGCCAAAAAGGAATTGCGTAC|CATTTAAAATGCGTCGTTGTTAGCCGGAAC
GTCCCTACCATACGAACTACCATACGAAAT|GTGATTTAGTGCAAGGTCCAAAGGAATCTC
GCCACCCGGGGTTAGTAGCATCATGTATTA|AGAGGAGTAGAAATGTTTAGCGCAACGAAA
TCACAGGGACCCTACCATACGAAATAAAAT|GCAGCGGTTAGCAGGTGGTGCTCTACCTGT
AGGGACCCTACCATACGAAATAAAATCCGG|CGGTTAGCAGGTGGTGCTCTACCTGTTATC
TTAAGCTACCATACGAAATAAAATCCGGTT|AAAACGAGCTTCAACCGGAGCACGAGGAGT
AATAAAATCCGGTTAGCAGTGGCCCTGCTA|CGAACTACCATACGAAATAAAATCCGGTTA
CCTCCGAACCGAGATCCAGTCGACATTCCA|CTTAGGGGCGGAACGTGGCATCTTTATCCG
GCGATAGTAACGGCTTGCTGTCCTAGAAAC|TCCGGTTAGCAGGAAGTCCTCACAGGGACC
CCGCTCTACCATACGAAATAAAATCCGGTT|CCATCGTGCCACCCGGGGTTAGTAGCATCA
ATCCGGTTAGCAGACTGGCTAGTTTTATGA|CGTCGCTCACGGTACGCTAAAACTTGATTA
AGCACGAGGAGTCCAAGCACTCATTTAAAA|CATACGAAATAAAATCCGGTTAGCAGTGCT
TTAATTCTCAGCTCACTACTACCATACGAA|CTACCATACGAAATAAAATCCGGTTAGCAG
AATAAAATCCGGTTAGCAGGGGATGAATAG|GGAGCACGAGGAGTCCAAGCACTCATTTAA
GCACTCATTTAAAATGCGTCGTTGTTAGCC|CGGTTAGCAGTGCTCCTTACGGATCTACCA
TCTCTAGTTCATTACACCTGGCACGGCTTC|TATCAAGGATATCTACCATACGAAATAAAA
GTCCTCACAGGGACCCTACCATACGAAATA|GTTAGCAGCGGTTAGCAGGTGGTGCTCTAC
AATAAAGATTACCGTTCTTAGCGTCGCTCA|TCTGTGGCGCTACCATACGAAATAAAATCC
TCCGGTTAGCAGAGAGGAAAACCACGGGAG|AATCAGGGAGGACGCTTGGCCCATTCTCTC
AACTACCATACGAAATAAAATCCGGTTAGC|GGTCCAAAGGAATCTCTCTAGTTCATTACA
GTGGCATCTTTATCCGAAGTTAGCATTGCC|AATTCGTCCTTGGGCGTTCGGAAGCAAGCG
AAAATCCGGTTAGCAGGAAGTCCTCACAGG|CCATACGAAATAAAATCCGGTTAGCAGCGG
AGGAGTCCAAGCACTCATTTAAAATGCGTC|AAATAAAATCCGGTTAGCAGTGCTCCTTAC
TAAAATCCGGTTAGCAGGAAGTCCTCACAG|ACCATACGAAATAAAATCCGGTTAGCAGCG
ACGAAATAAAATCCGGTTAGCAGCGGTTAG|GACCAATAGCCGGCGACCCTTGAGAGTGGG
ATAAAATCCGGTTAGCAGACTGGCTAGTTT|CTTAGCGTCGCTCACGGTACGCTAAAACTT
GAAATAAAATCCGGTTAGCAGCGGTTAGCA|CCAATAGCCGGCGACCCTTGAGAGTGGGCC
CGGTTAGCAGCGGTTAGCAGGTGGTGCTCT|CGACCCTTGAGAGTGGGCCGTCGGTTTCTT
ACGAAATAAAATCCGGTTAGCAGAGGAGTA|CAACGTGCGCACGCGAAGGCGTTTTCACGC
CTCTCCACATCTTCCGGGGCTAATAAAGAT|GGCGGTGGGGGATCCGATTTTTCTGTGGCG
CGTTTTCACGCTTATTTCCGGGGCCTTAAT|GGGAGGGTTTGGCCCGAAGTACGGACTACC
CATACGAAATAAAATCCGGTTAGCAGCGGT|AAAGACCAATAGCCGGCGACCCTTGAGAGT
GATATCTACCATACGAAATAAAATCCGGTT|CATACGAAATAAAATCCGGTTAGCAGGGGA
CCATACGAAATAAAATCCGGTTAGCAGGGG|CTTCAACCGGAGCACGAGGAGTCCAAGCAC
GTCCAAGCACTCATTTAAAATGCGTCGTTG|AAAATCCGGTTAGCAGTGCTCCTTACGGAT
ACGCTAAAACTTGATTAAGGGCTTAGGGGC|AGCAGGACACTTGCCTTCGAAAGTCCGATA
CTACCATACGAAATAAAATCCGGTTAGCAG|CTTCAAAGACCAATAGCCGGCGACCCTTGA
TAAAATCCGGTTAGCAGGGGCCGCTCTCTG|GTTAGCAGGGGATGAATAGGCCGCCAAAAA
ACCTACCATACGAAATAAAATCCGGTTAGC|AGCAGATAAAATCCTACCATACGAAATAAA
GAGCACGAGGAGTCCAAGCACTCATTTAAA|CCATACGAAATAAAATCCGGTTAGCAGTGC
TCTTCTACACGCTTTTCAATGAGCCCCCTA|GAATTGCGTACGACTAGCTACCATACGAAA
CCATACGAAATAAAATCCGGTTAGCAGGAC|GACCCTGCTTAACGATTTTCCTAGCAGACA
CCGGTTAGCAGGAAGTCCTCACAGGGACCC|CGAAATAAAATCCGGTTAGCAGCGGTTAGC
ATCTTCCGGGGCTAATAAAGATTACCGTTC|GGGATCCGATTTTTCTGTGGCGCTACCATA
AATAAAATCCGGTTAGCAGGACACTTGCCT|TTAACGATTTTCCTAGCAGACACTTGCTCA
CTCCTTACGGATCTACCATACGAAATAAAA|CCCTCCGAACCGAGATCCAGTCGACATTCC
AGGTGGTGCTCTACCTGTTATCCTCAAATA|CGTCGGTTTCTTTCCAGCACGGGCAGTCGA
AATAAAATCCGGTTAGCAGGAAGTCCTCAC|CTACCATACGAAATAAAATCCGGTTAGCAG
CTCCGAACCGAGATCCAGTCGACATTCCAA|TTAGGGGCGGAACGTGGCATCTTTATCCGA
AAATCCGGTTAGCAGCTATGGGAAGCCTAC|AAAATCCGGTTAGCAGGTGTTTCCTGTCCC
TTCTACACGCTTTTCAATGAGCCCCCTACG|ATTGCGTACGACTAGCTACCATACGAAATA
GCGTCGCTCACGGTACGCTAAAACTTGATT|AATAAAATCCGGTTAGCAGGACACTTGCCT
CTCCACATCTTCCGGGGCTAATAAAGATTA|CGGTGGGGGATCCGATTTTTCTGTGGCGCT
TTAGCAGAGGAGTAGAAATGTTTAGCGCAA|AGGCGTTTTCACGCTTATTTCCGGGGCCTT
TGCCGCCACTAGAAGGCGGTGGGGGATCCG|AGCGCGCGTTTTAGTGAAGCAGGTTTGTGT
GGGTTAGTAGCATCATGTATTAAGCTACCA|AGAAATGTTTAGCGCAACGAAAACGAGCTT
TCCGGTTAGCAGGACACTTGCCTTCGAAAG|TTTTCCTAGCAGACACTTGCTCAGCTCGAC
AATAAAATCCGGTTAGCAGGTGTTTCCTGT|CTACCTGTTATCCTCAAATAACATAGTTGT
ACCGAGATCCAGTCGACATTCCAATCAGGG|GCGGAACGTGGCATCTTTATCCGAAGTTAG
GATCCAGTCGACATTCCAATCAGGGAGGAC|ACGTGGCATCTTTATCCGAAGTTAGCATTG
CTAGTTTTATGACGTCCCTCCGAACCGAGA|AAAACTTGATTAAGGGCTTAGGGGCGGAAC
AGAGTGGGCCGTCGGTTTCTTTCCAGCACG|CTCTTCTACACGCTTTTCAATGAGCCCCCT
TGAGCCCCCTACGACCATACCATCGTGCCA|ACCATACGAAATAAAATCCGGTTAGCAGAG
TACCATACGAAATAAAATCCGGTTAGCAGG|AGATAAAATCCTACCATACGAAATAAAATC
GCGTCGTTGTTAGCCGGAACGAACACGCTA|CTTACGGATCTACCATACGAAATAAAATCC
AGGACGCTTGGCCCATTCTCTCCACATCTT|CATTGCCGCCACTAGAAGGCGGTGGGGGAT
CGAAGGCGTTTTCACGCTTATTTCCGGGGC|AACCACGGGAGGGTTTGGCCCGAAGTACGG
AAAATCCGGTTAGCAGCTATGGGAAGCCTA|TAAAATCCGGTTAGCAGGTGTTTCCTGTCC
CATACGAAATAAAATCCGGTTAGCAGGGGC|TAAAATCCGGTTAGCAGGGGATGAATAGGC
GCCGCTCTCTGCTCTTCTACACGCTTTTCA|GCCGCCAAAAAGGAATTGCGTACGACTAGC
CGGAGCACGAGGAGTCCAAGCACTCATTTA|TACCATACGAAATAAAATCCGGTTAGCAGT
ATCCGGTTAGCAGGTGTTTCCTGTCCCTAC|GTTATCCTCAAATAACATAGTTGTGATTTA
CCGAAGTACGGACTACCATACGAAATAAAA|CCGGGGCTAATAAAGATTACCGTTCTTAGC
CGCACGCGAAGGCGTTTTCACGCTTATTTC|GAGGAAAACCACGGGAGGGTTTGGCCCGAA
AGCACGGGCAGTCGACCGCTCTACCATACG|CCCCCTACGACCATACCATCGTGCCACCCG
AAACTACCATACGAAATAAAATCCGGTTAG|GACCCTACCATACGAAATAAAATCCGGTTA
TGCTGTCCTAGAAACTACCATACGAAATAA|GTCCTCACAGGGACCCTACCATACGAAATA
GTCGGTTTCTTTCCAGCACGGGCAGTCGAC|CGCTTTTCAATGAGCCCCCTACGACCATAC
ATCCGGTTAGCAGGACACTTGCCTTCGAAA|ATTTTCCTAGCAGACACTTGCTCAGCTCGA
CGTCGTTGTTAGCCGGAACGAACACGCTAC|TTACGGATCTACCATACGAAATAAAATCCG
AAGCCTACCATACGAAATAAAATCCGGTTA|CCTGTCCCTACCATACGAACTACCATACGA
CGGTTAGCAGAGAGGAAAACCACGGGAGGG|TCAGGGAGGACGCTTGGCCCATTCTCTCCA
AGCAGACTGGCTAGTTTTATGACGTCCCTC|ACGGTACGCTAAAACTTGATTAAGGGCTTA
AAATAAAATCCGGTTAGCAGGACACTTGCC|CTTAACGATTTTCCTAGCAGACACTTGCTC
AGTGGCCCTGCTACCTACCATACGAAATAA|TAAAATCCGGTTAGCAGATAAAATCCTACC
GTGCAAGGTCCAAAGGAATCTCTCTAGTTC|AATAAAATCCGGTTAGCAGGTATCAAGGAT
GTTAGCAGGTATCAAGGATATCTACCATAC|TCATGTATTAAGCTACCATACGAAATAAAA
ACGAGGAGTCCAAGCACTCATTTAAAATGC|ACGAAATAAAATCCGGTTAGCAGTGCTCCT
CGCTTGGCCCATTCTCTCCACATCTTCCGG|GCCGCCACTAGAAGGCGGTGGGGGATCCGA
AATTGCGTACGACTAGCTACCATACGAAAT|TAGCCGGAACGAACACGCTACGACAACGTG
GCTGTCCTAGAAACTACCATACGAAATAAA|TCCTCACAGGGACCCTACCATACGAAATAA
AAATGTTTAGCGCAACGAAAACGAGCTTCA|TATTTCCGGGGCCTTAATTCTCAGCTCACT
GAACGAACACGCTACGACAACGTGCGCACG|ACGAAATAAAATCCGGTTAGCAGAGAGGAA
CCTTACGGATCTACCATACGAAATAAAATC|CTCCGAACCGAGATCCAGTCGACATTCCAA
GCTCACGGTACGCTAAAACTTGATTAAGGG|AATCCGGTTAGCAGGACACTTGCCTTCGAA
ATAAAATCCGGTTAGCAGTGGCCCTGCTAC|GAACTACCATACGAAATAAAATCCGGTTAG
CAGAGGAGTAGAAATGTTTAGCGCAACGAA|GTTTTCACGCTTATTTCCGGGGCCTTAATT
ATACGAACTACCATACGAAATAAAATCCGG|TGCAAGGTCCAAAGGAATCTCTCTAGTTCA
TCCTTACGGATCTACCATACGAAATAAAAT|CCTCCGAACCGAGATCCAGTCGACATTCCA
AGGGGCCGCTCTCTGCTCTTCTACACGCTT|ATAGGCCGCCAAAAAGGAATTGCGTACGAC
CCGGGGCTAATAAAGATTACCGTTCTTAGC|CCGATTTTTCTGTGGCGCTACCATACGAAA
CATACGAAATAAAATCCGGTTAGCAGGAAG|TAAAATCCTACCATACGAAATAAAATCCGG
TGGGGGATCCGATTTTTCTGTGGCGCTACC|CAGGTTTGTGTTCATCACATCGTGTCGAGA
TTAGCAGGGGATGAATAGGCCGCCAAAAAG|GTCCAAGCACTCATTTAAAATGCGTCGTTG
GGGATGAATAGGCCGCCAAAAAGGAATTGC|CACTCATTTAAAATGCGTCGTTGTTAGCCG
GTTAGCAGGGGATGAATAGGCCGCCAAAAA|AGTCCAAGCACTCATTTAAAATGCGTCGTT
GAGCTTCAACCGGAGCACGAGGAGTCCAAG|AGCTCACTACTACCATACGAAATAAAATCC
TTGGCCCATTCTCTCCACATCTTCCGGGGC|GCCACTAGAAGGCGGTGGGGGATCCGATTT
GAAAACGAGCTTCAACCGGAGCACGAGGAG|ATTCTCAGCTCACTACTACCATACGAAATA
TCCCTACCATACGAACTACCATACGAAATA|TGATTTAGTGCAAGGTCCAAAGGAATCTCT
GTTAGCAGCGGTTAGCAGGTGGTGCTCTAC|ACCCTTGAGAGTGGGCCGTCGGTTTCTTTC
TACCATACGAACTACCATACGAAATAAAAT|TTAGTGCAAGGTCCAAAGGAATCTCTCTAG
TTAGTAGCATCATGTATTAAGCTACCATAC|AATGTTTAGCGCAACGAAAACGAGCTTCAA
GGTGCTCTACCTGTTATCCTCAAATAACAT|GGTTTCTTTCCAGCACGGGCAGTCGACCGC
GAAGTTAGCATTGCCGCCACTAGAAGGCGG|GTTCGGAAGCAAGCGCGCGTTTTAGTGAAG
GAGTGGGCCGTCGGTTTCTTTCCAGCACGG|TCTTCTACACGCTTTTCAATGAGCCCCCTA
ATCCGGTTAGCAGGAAGTCCTCACAGGGAC|TACGAAATAAAATCCGGTTAGCAGCGGTTA
TATGGGAAGCCTACCATACGAAATAAAATC|GTGTTTCCTGTCCCTACCATACGAACTACC
ATAAAATCCGGTTAGCAGGGGCCGCTCTCT|GGTTAGCAGGGGATGAATAGGCCGCCAAAA
TTTCTGTGGCGCTACCATACGAAATAAAAT|TCACATCGTGTCGAGACCCTGCTTAACGAT
CAGGGGATGAATAGGCCGCCAAAAAGGAAT|AAGCACTCATTTAAAATGCGTCGTTGTTAG
TCCTCACAGGGACCCTACCATACGAAATAA|TTAGCAGCGGTTAGCAGGTGGTGCTCTACC
CAGCTCACTACTACCATACGAAATAAAATC|CGAAATAAAATCCGGTTAGCAGACTGGCTA
AAAATCCGGTTAGCAGGGGATGAATAGGCC|GCACGAGGAGTCCAAGCACTCATTTAAAAT
TCCGGTTAGCAGGAAGTCCTCACAGGGACC|ACGAAATAAAATCCGGTTAGCAGCGGTTAG
GAAGTACGGACTACCATACGAAATAAAATC|GGGGCTAATAAAGATTACCGTTCTTAGCGT
TCCGATTTTTCTGTGGCGCTACCATACGAA|GTGTTCATCACATCGTGTCGAGACCCTGCT
AAAGATTACCGTTCTTAGCGTCGCTCACGG|GTGGCGCTACCATACGAAATAAAATCCGGT
GAGCCCCCTACGACCATACCATCGTGCCAC|CCATACGAAATAAAATCCGGTTAGCAGAGG
TCCGAAGTTAGCATTGCCGCCACTAGAAGG|GGCGTTCGGAAGCAAGCGCGCGTTTTAGTG
TAGTAGCATCATGTATTAAGCTACCATACG|ATGTTTAGCGCAACGAAAACGAGCTTCAAC
AGCCCCCTACGACCATACCATCGTGCCACC|CATACGAAATAAAATCCGGTTAGCAGAGGA
AAGCTACCATACGAAATAAAATCCGGTTAG|AACGAGCTTCAACCGGAGCACGAGGAGTCC
ATCTCTCTAGTTCATTACACCTGGCACGGC|AGGTATCAAGGATATCTACCATACGAAATA
AAAGACCAATAGCCGGCGACCCTTGAGAGT|TCCGGTTAGCAGGGGCCGCTCTCTGCTCTT
ATGTATTAAGCTACCATACGAAATAAAATC|CAACGAAAACGAGCTTCAACCGGAGCACGA
TAAAATCCTACCATACGAAATAAAATCCGG|GGCACGGCTTCAAAGACCAATAGCCGGCGA
CCATACGAAATAAAATCCGGTTAGCAGGTA|CCACCCGGGGTTAGTAGCATCATGTATTAA
CGGATCTACCATACGAAATAAAATCCGGTT|AACCGAGATCCAGTCGACATTCCAATCAGG
TATCAAGGATATCTACCATACGAAATAAAA|AAGCTACCATACGAAATAAAATCCGGTTAG
TAAAATCCGGTTAGCAGCGGTTAGCAGGTG|TAGCCGGCGACCCTTGAGAGTGGGCCGTCG
TCTGTGGCGCTACCATACGAAATAAAATCC|ACATCGTGTCGAGACCCTGCTTAACGATTT
GGCCCTGCTACCTACCATACGAAATAAAAT|AATCCGGTTAGCAGATAAAATCCTACCATA
AAATCCGGTTAGCAGACTGGCTAGTTTTAT|AGCGTCGCTCACGGTACGCTAAAACTTGAT
GCGACCCTTGAGAGTGGGCCGTCGGTTTCT|CCGCTCTCTGCTCTTCTACACGCTTTTCAA
GAAAACCACGGGAGGGTTTGGCCCGAAGTA|TGGCCCATTCTCTCCACATCTTCCGGGGCT
CGTGCCACCCGGGGTTAGTAGCATCATGTA|AGCAGAGGAGTAGAAATGTTTAGCGCAACG
ACTACTACCATACGAAATAAAATCCGGTTA|AAAATCCGGTTAGCAGACTGGCTAGTTTTA
GTTTGGCCCGAAGTACGGACTACCATACGA|ACATCTTCCGGGGCTAATAAAGATTACCGT
ACCAATAGCCGGCGACCCTTGAGAGTGGGC|GTTAGCAGGGGCCGCTCTCTGCTCTTCTAC
CAGGGGCCGCTCTCTGCTCTTCTACACGCT|AATAGGCCGCCAAAAAGGAATTGCGTACGA
TAGCAGCTATGGGAAGCCTACCATACGAAA|TTAGCAGGTGTTTCCTGTCCCTACCATACG
CGTTGTTAGCCGGAACGAACACGCTACGAC|CGGATCTACCATACGAAATAAAATCCGGTT
TTTTTCTGTGGCGCTACCATACGAAATAAA|CATCACATCGTGTCGAGACCCTGCTTAACG
GAAATAAAATCCGGTTAGCAGTGGCCCTGC|TACGAACTACCATACGAAATAAAATCCGGT
CGACATTCCAATCAGGGAGGACGCTTGGCC|TCTTTATCCGAAGTTAGCATTGCCGCCACT
TCTTCCGGGGCTAATAAAGATTACCGTTCT|GGATCCGATTTTTCTGTGGCGCTACCATAC
TCCGGTTAGCAGGTGTTTCCTGTCCCTACC|TTATCCTCAAATAACATAGTTGTGATTTAG
CTGTGGCGCTACCATACGAAATAAAATCCG|CATCGTGTCGAGACCCTGCTTAACGATTTT
GTTCATTACACCTGGCACGGCTTCAAAGAC|GGATATCTACCATACGAAATAAAATCCGGT
TCCGGTTAGCAGCGGTTAGCAGGTGGTGCT|GGCGACCCTTGAGAGTGGGCCGTCGGTTTC
GAAATAAAATCCGGTTAGCAGCTATGGGAA|CGAAATAAAATCCGGTTAGCAGGTGTTTCC
TCCTGTCCCTACCATACGAACTACCATACG|AGTTGTGATTTAGTGCAAGGTCCAAAGGAA
CGAAATAAAATCCGGTTAGCAGGTATCAAG|CGGGGTTAGTAGCATCATGTATTAAGCTAC
CCGCCAAAAAGGAATTGCGTACGACTAGCT|ATGCGTCGTTGTTAGCCGGAACGAACACGC
GAAATAAAATCCGGTTAGCAGAGGAGTAGA|ACGTGCGCACGCGAAGGCGTTTTCACGCTT
TTCCAGCACGGGCAGTCGACCGCTCTACCA|TGAGCCCCCTACGACCATACCATCGTGCCA
GGATCCGATTTTTCTGTGGCGCTACCATAC|TTTGTGTTCATCACATCGTGTCGAGACCCT
GCAAGGTCCAAAGGAATCTCTCTAGTTCAT|TAAAATCCGGTTAGCAGGTATCAAGGATAT
TCAACCGGAGCACGAGGAGTCCAAGCACTC|ACTACTACCATACGAAATAAAATCCGGTTA
AAAAGGAATTGCGTACGACTAGCTACCATA|CGTTGTTAGCCGGAACGAACACGCTACGAC
CATACGAAATAAAATCCGGTTAGCAGGTGT|TGGTGCTCTACCTGTTATCCTCAAATAACA
CCGTTCTTAGCGTCGCTCACGGTACGCTAA|ACCATACGAAATAAAATCCGGTTAGCAGGA
CTCACTACTACCATACGAAATAAAATCCGG|AATAAAATCCGGTTAGCAGACTGGCTAGTT
GGGCCTTAATTCTCAGCTCACTACTACCAT|ACGGACTACCATACGAAATAAAATCCGGTT
GTTAGCAGTGCTCCTTACGGATCTACCATA|TTTATGACGTCCCTCCGAACCGAGATCCAG
TGTTTAGCGCAACGAAAACGAGCTTCAACC|TTCCGGGGCCTTAATTCTCAGCTCACTACT
GGAACGTGGCATCTTTATCCGAAGTTAGCA|AAATGAATTCGTCCTTGGGCGTTCGGAAGC
ACGACTAGCTACCATACGAAATAAAATCCG|ACGAACACGCTACGACAACGTGCGCACGCG
CCTGCTACCTACCATACGAAATAAAATCCG|CCGGTTAGCAGATAAAATCCTACCATACGA
CGGTTAGCAGGTATCAAGGATATCTACCAT|CATCATGTATTAAGCTACCATACGAAATAA
TCTGCTCTTCTACACGCTTTTCAATGAGCC|AAAAGGAATTGCGTACGACTAGCTACCATA
TTAGCAGTGCTCCTTACGGATCTACCATAC|TTATGACGTCCCTCCGAACCGAGATCCAGT
TAGCGTCGCTCACGGTACGCTAAAACTTGA|GAAATAAAATCCGGTTAGCAGGACACTTGC
ACGAAAACGAGCTTCAACCGGAGCACGAGG|TAATTCTCAGCTCACTACTACCATACGAAA
TTTCACGCTTATTTCCGGGGCCTTAATTCT|AGGGTTTGGCCCGAAGTACGGACTACCATA
AAATCCGGTTAGCAGGTGTTTCCTGTCCCT|CTGTTATCCTCAAATAACATAGTTGTGATT
AAAACGAGCTTCAACCGGAGCACGAGGAGT|TTCTCAGCTCACTACTACCATACGAAATAA
ATCAGGGAGGACGCTTGGCCCATTCTCTCC|AAGTTAGCATTGCCGCCACTAGAAGGCGGT
TTGTTAGCCGGAACGAACACGCTACGACAA|GATCTACCATACGAAATAAAATCCGGTTAG
GGGCTTAGGGGCGGAACGTGGCATCTTTAT|GAAAGTCCGATAAAATGAATTCGTCCTTGG
GGAGTCCAAGCACTCATTTAAAATGCGTCG|AATAAAATCCGGTTAGCAGTGCTCCTTACG
TTAGCAGAGAGGAAAACCACGGGAGGGTTT|GGGAGGACGCTTGGCCCATTCTCTCCACAT
TTTGGCCCGAAGTACGGACTACCATACGAA|CATCTTCCGGGGCTAATAAAGATTACCGTT
GGTTTGGCCCGAAGTACGGACTACCATACG|CACATCTTCCGGGGCTAATAAAGATTACCG
AAATCCGGTTAGCAGTGCTCCTTACGGATC|GGCTAGTTTTATGACGTCCCTCCGAACCGA
TAAGCTACCATACGAAATAAAATCCGGTTA|AAACGAGCTTCAACCGGAGCACGAGGAGTC
AAGACCAATAGCCGGCGACCCTTGAGAGTG|CCGGTTAGCAGGGGCCGCTCTCTGCTCTTC
CTCACAGGGACCCTACCATACGAAATAAAA|AGCAGCGGTTAGCAGGTGGTGCTCTACCTG
TACGAAATAAAATCCGGTTAGCAGACTGGC|ACCGTTCTTAGCGTCGCTCACGGTACGCTA
AGTAACGGCTTGCTGTCCTAGAAACTACCA|TTAGCAGGAAGTCCTCACAGGGACCCTACC
ATTAAGGGCTTAGGGGCGGAACGTGGCATC|CCTTCGAAAGTCCGATAAAATGAATTCGTC
GATCTACCATACGAAATAAAATCCGGTTAG|CCGAGATCCAGTCGACATTCCAATCAGGGA
ATAAAATCCGGTTAGCAGGGGATGAATAGG|GAGCACGAGGAGTCCAAGCACTCATTTAAA
AGCACTCATTTAAAATGCGTCGTTGTTAGC|CCGGTTAGCAGTGCTCCTTACGGATCTACC
GTTAGCAGGTGGTGCTCTACCTGTTATCCT|GTGGGCCGTCGGTTTCTTTCCAGCACGGGC
CACGCGAAGGCGTTTTCACGCTTATTTCCG|GGAAAACCACGGGAGGGTTTGGCCCGAAGT
CTACCATACGAAATAAAATCCGGTTAGCAG|CCTACCATACGAAATAAAATCCGGTTAGCA
CGTACGACTAGCTACCATACGAAATAAAAT|GGAACGAACACGCTACGACAACGTGCGCAC
TTAGCAGGTGTTTCCTGTCCCTACCATACG|CTCAAATAACATAGTTGTGATTTAGTGCAA
AATAGCCGGCGACCCTTGAGAGTGGGCCGT|AGCAGGGGCCGCTCTCTGCTCTTCTACACG
GTAGCATCATGTATTAAGCTACCATACGAA|GTTTAGCGCAACGAAAACGAGCTTCAACCG
GGCTTAGGGGCGGAACGTGGCATCTTTATC|AAAGTCCGATAAAATGAATTCGTCCTTGGG
GTTAGCAGGACACTTGCCTTCGAAAGTCCG|CCTAGCAGACACTTGCTCAGCTCGACCAGG
CAAAGGAATCTCTCTAGTTCATTACACCTG|GGTTAGCAGGTATCAAGGATATCTACCATA
AGATTACCGTTCTTAGCGTCGCTCACGGTA|GGCGCTACCATACGAAATAAAATCCGGTTA
ATAAAATCCGGTTAGCAGCGGTTAGCAGGT|ATAGCCGGCGACCCTTGAGAGTGGGCCGTC
CCATACGAAATAAAATCCGGTTAGCAGATA|AAAGGAATCTCTCTAGTTCATTACACCTGG
CCCCCTACGACCATACCATCGTGCCACCCG|TACGAAATAAAATCCGGTTAGCAGAGGAGT
CAAGGATATCTACCATACGAAATAAAATCC|CTACCATACGAAATAAAATCCGGTTAGCAG
CAACGTGCGCACGCGAAGGCGTTTTCACGC|TAGCAGAGAGGAAAACCACGGGAGGGTTTG
TATCCTCAAATAACATAGTTGTGATTTAGT|ACGGGCAGTCGACCGCTCTACCATACGAAA
ACCATACGAAATAAAATCCGGTTAGCAGCG|TCAAAGACCAATAGCCGGCGACCCTTGAGA
GTGCGCACGCGAAGGCGTTTTCACGCTTAT|AGAGAGGAAAACCACGGGAGGGTTTGGCCC
GAGTCCAAGCACTCATTTAAAATGCGTCGT|ATAAAATCCGGTTAGCAGTGCTCCTTACGG
TAAAACTTGATTAAGGGCTTAGGGGCGGAA|GGACACTTGCCTTCGAAAGTCCGATAAAAT
AACGTGCGCACGCGAAGGCGTTTTCACGCT|AGCAGAGAGGAAAACCACGGGAGGGTTTGG
CGTCCCTCCGAACCGAGATCCAGTCGACAT|AGGGCTTAGGGGCGGAACGTGGCATCTTTA
GACCGCTCTACCATACGAAATAAAATCCGG|TACCATCGTGCCACCCGGGGTTAGTAGCAT
TTCTTTCCAGCACGGGCAGTCGACCGCTCT|TCAATGAGCCCCCTACGACCATACCATCGT
AGCTATGGGAAGCCTACCATACGAAATAAA|CAGGTGTTTCCTGTCCCTACCATACGAACT
ACGGCTTGCTGTCCTAGAAACTACCATACG|CAGGAAGTCCTCACAGGGACCCTACCATAC
TAAAATCCGGTTAGCAGTGCTCCTTACGGA|CTGGCTAGTTTTATGACGTCCCTCCGAACC
CGAAATAAAATCCGGTTAGCAGCGGTTAGC|ACCAATAGCCGGCGACCCTTGAGAGTGGGC
AGGGGCGGAACGTGGCATCTTTATCCGAAG|CCGATAAAATGAATTCGTCCTTGGGCGTTC
ACGCTTTTCAATGAGCCCCCTACGACCATA|TACGACTAGCTACCATACGAAATAAAATCC
ACCATACGAACTACCATACGAAATAAAATC|TAGTGCAAGGTCCAAAGGAATCTCTCTAGT
ACTGGCTAGTTTTATGACGTCCCTCCGAAC|ACGCTAAAACTTGATTAAGGGCTTAGGGGC
GGTTAGCAGGAAGTCCTCACAGGGACCCTA|AAATAAAATCCGGTTAGCAGCGGTTAGCAG
CGAAATAAAATCCGGTTAGCAGGGGATGAA|ACCGGAGCACGAGGAGTCCAAGCACTCATT
GGTTAGCAGAGAGGAAAACCACGGGAGGGT|CAGGGAGGACGCTTGGCCCATTCTCTCCAC
TAACATAGTTGTGATTTAGTGCAAGGTCCA|GACCGCTCTACCATACGAAATAAAATCCGG
ATACGAAATAAAATCCGGTTAGCAGAGAGG|CAGTCGACATTCCAATCAGGGAGGACGCTT
AAATAAAATCCGGTTAGCAGGAAGTCCTCA|CCTACCATACGAAATAAAATCCGGTTAGCA
GAGTAGAAATGTTTAGCGCAACGAAAACGA|CACGCTTATTTCCGGGGCCTTAATTCTCAG
AAGGCGGTGGGGGATCCGATTTTTCTGTGG|AGTGAAGCAGGTTTGTGTTCATCACATCGT
ATCAAGGATATCTACCATACGAAATAAAAT|AGCTACCATACGAAATAAAATCCGGTTAGC
GCTTGCTGTCCTAGAAACTACCATACGAAA|GAAGTCCTCACAGGGACCCTACCATACGAA
CGGTTAGCAGTGGCCCTGCTACCTACCATA|ATACGAAATAAAATCCGGTTAGCAGATAAA
GTTAGCCGGAACGAACACGCTACGACAACG|TCTACCATACGAAATAAAATCCGGTTAGCA
AAATAAAATCCGGTTAGCAGATAAAATCCT|TCTCTCTAGTTCATTACACCTGGCACGGCT
AAATAAAATCCGGTTAGCAGACTGGCTAGT|TTCTTAGCGTCGCTCACGGTACGCTAAAAC
AGAGAGGAAAACCACGGGAGGGTTTGGCCC|GACGCTTGGCCCATTCTCTCCACATCTTCC
ATCTACCATACGAAATAAAATCCGGTTAGC|CGAGATCCAGTCGACATTCCAATCAGGGAG
TGTTTCCTGTCCCTACCATACGAACTACCA|ACATAGTTGTGATTTAGTGCAAGGTCCAAA
TTTCAATGAGCCCCCTACGACCATACCATC|CTAGCTACCATACGAAATAAAATCCGGTTA
GCCGGCGACCCTTGAGAGTGGGCCGTCGGT|GGGGCCGCTCTCTGCTCTTCTACACGCTTT
AGCAGGTGGTGCTCTACCTGTTATCCTCAA|GGCCGTCGGTTTCTTTCCAGCACGGGCAGT
GCTCCTTACGGATCTACCATACGAAATAAA|TCCCTCCGAACCGAGATCCAGTCGACATTC
GTTGTGATTTAGTGCAAGGTCCAAAGGAAT|CTACCATACGAAATAAAATCCGGTTAGCAG
ATAAAATCCTACCATACGAAATAAAATCCG|TGGCACGGCTTCAAAGACCAATAGCCGGCG
GACGTCCCTCCGAACCGAGATCCAGTCGAC|TAAGGGCTTAGGGGCGGAACGTGGCATCTT
ACTCATTTAAAATGCGTCGTTGTTAGCCGG|GTTAGCAGTGCTCCTTACGGATCTACCATA
ACTACCATACGAAATAAAATCCGGTTAGCA|AAAGATTACCGTTCTTAGCGTCGCTCACGG
GAAATAAAATCCGGTTAGCAGGGGCCGCTC|TCCGGTTAGCAGGGGATGAATAGGCCGCCA
TTTTCAATGAGCCCCCTACGACCATACCAT|ACTAGCTACCATACGAAATAAAATCCGGTT
AAATAAAATCCGGTTAGCAGGGGCCGCTCT|CCGGTTAGCAGGGGATGAATAGGCCGCCAA
AAACTTGATTAAGGGCTTAGGGGCGGAACG|ACACTTGCCTTCGAAAGTCCGATAAAATGA
CACGGGAGGGTTTGGCCCGAAGTACGGACT|ATTCTCTCCACATCTTCCGGGGCTAATAAA
ACAGGGACCCTACCATACGAAATAAAATCC|AGCGGTTAGCAGGTGGTGCTCTACCTGTTA
GGGCTAATAAAGATTACCGTTCTTAGCGTC|ATTTTTCTGTGGCGCTACCATACGAAATAA
CGGCTTGCTGTCCTAGAAACTACCATACGA|AGGAAGTCCTCACAGGGACCCTACCATACG
GTGGGCCGTCGGTTTCTTTCCAGCACGGGC|TTCTACACGCTTTTCAATGAGCCCCCTACG
CGCTACCATACGAAATAAAATCCGGTTAGC|GTCGAGACCCTGCTTAACGATTTTCCTAGC
ACTACCATACGAAATAAAATCCGGTTAGCA|CCCTACCATACGAAATAAAATCCGGTTAGC
CTACCTGTTATCCTCAAATAACATAGTTGT|TTTCCAGCACGGGCAGTCGACCGCTCTACC
TCTACACGCTTTTCAATGAGCCCCCTACGA|TTGCGTACGACTAGCTACCATACGAAATAA
GTGATTTAGTGCAAGGTCCAAAGGAATCTC|CCATACGAAATAAAATCCGGTTAGCAGGTA
AGCAGAGAGGAAAACCACGGGAGGGTTTGG|GAGGACGCTTGGCCCATTCTCTCCACATCT
TTCTGTGGCGCTACCATACGAAATAAAATC|CACATCGTGTCGAGACCCTGCTTAACGATT
ACATCTTCCGGGGCTAATAAAGATTACCGT|GGGGGATCCGATTTTTCTGTGGCGCTACCA
CCAATAGCCGGCGACCCTTGAGAGTGGGCC|TTAGCAGGGGCCGCTCTCTGCTCTTCTACA
CTACCATACGAAATAAAATCCGGTTAGCAG|GCTACGACAACGTGCGCACGCGAAGGCGTT
GCGAAGGCGTTTTCACGCTTATTTCCGGGG|AAACCACGGGAGGGTTTGGCCCGAAGTACG
TACTACCATACGAAATAAAATCCGGTTAGC|AATCCGGTTAGCAGACTGGCTAGTTTTATG
ATTTTTCTGTGGCGCTACCATACGAAATAA|TCATCACATCGTGTCGAGACCCTGCTTAAC
GCTTCAACCGGAGCACGAGGAGTCCAAGCA|CTCACTACTACCATACGAAATAAAATCCGG
AATAAAATCCGGTTAGCAGACTGGCTAGTT|TCTTAGCGTCGCTCACGGTACGCTAAAACT
AGCTACCATACGAAATAAAATCCGGTTAGC|ACGCTACGACAACGTGCGCACGCGAAGGCG
ATAAAGATTACCGTTCTTAGCGTCGCTCAC|CTGTGGCGCTACCATACGAAATAAAATCCG
CCGGTTAGCAGGTGTTTCCTGTCCCTACCA|TATCCTCAAATAACATAGTTGTGATTTAGT
CGAAATAAAATCCGGTTAGCAGAGGAGTAG|AACGTGCGCACGCGAAGGCGTTTTCACGCT
ACGAAATAAAATCCGGTTAGCAGGGGCCGC|AATCCGGTTAGCAGGGGATGAATAGGCCGC
TCGACCGCTCTACCATACGAAATAAAATCC|CATACCATCGTGCCACCCGGGGTTAGTAGC
GATAAAATCCTACCATACGAAATAAAATCC|CTGGCACGGCTTCAAAGACCAATAGCCGGC
GGCTTCAAAGACCAATAGCCGGCGACCCTT|ATAAAATCCGGTTAGCAGGGGCCGCTCTCT
AGCAGCGGTTAGCAGGTGGTGCTCTACCTG|CTTGAGAGTGGGCCGTCGGTTTCTTTCCAG
TCCAATCAGGGAGGACGCTTGGCCCATTCT|TCCGAAGTTAGCATTGCCGCCACTAGAAGG
CATCTTTATCCGAAGTTAGCATTGCCGCCA|CGTCCTTGGGCGTTCGGAAGCAAGCGCGCG
AAAGGAATCTCTCTAGTTCATTACACCTGG|GTTAGCAGGTATCAAGGATATCTACCATAC
ACGGATCTACCATACGAAATAAAATCCGGT|GAACCGAGATCCAGTCGACATTCCAATCAG
ATAAAATCCGGTTAGCAGGTATCAAGGATA|GTTAGTAGCATCATGTATTAAGCTACCATA
GTTAGCAGATAAAATCCTACCATACGAAAT|ATTACACCTGGCACGGCTTCAAAGACCAAT
GGTTAGCAGGTGGTGCTCTACCTGTTATCC|AGTGGGCCGTCGGTTTCTTTCCAGCACGGG
CCGAAGTTAGCATTGCCGCCACTAGAAGGC|GCGTTCGGAAGCAAGCGCGCGTTTTAGTGA
CGGGGCCTTAATTCTCAGCTCACTACTACC|GTACGGACTACCATACGAAATAAAATCCGG
AAAATCCGGTTAGCAGAGAGGAAAACCACG|TTCCAATCAGGGAGGACGCTTGGCCCATTC
AAATAAAATCCGGTTAGCAGGTGTTTCCTG|TCTACCTGTTATCCTCAAATAACATAGTTG
GTTTTCACGCTTATTTCCGGGGCCTTAATT|GGAGGGTTTGGCCCGAAGTACGGACTACCA
TGGTGCTCTACCTGTTATCCTCAAATAACA|CGGTTTCTTTCCAGCACGGGCAGTCGACCG
CATACGAAATAAAATCCGGTTAGCAGACTG|TTACCGTTCTTAGCGTCGCTCACGGTACGC
AGGTGTTTCCTGTCCCTACCATACGAACTA|ATAACATAGTTGTGATTTAGTGCAAGGTCC
CTAGTTCATTACACCTGGCACGGCTTCAAA|CAAGGATATCTACCATACGAAATAAAATCC
TCACGCTTATTTCCGGGGCCTTAATTCTCA|GGTTTGGCCCGAAGTACGGACTACCATACG
TTTAGTGCAAGGTCCAAAGGAATCTCTCTA|ACGAAATAAAATCCGGTTAGCAGGTATCAA
TACACGCTTTTCAATGAGCCCCCTACGACC|GCGTACGACTAGCTACCATACGAAATAAAA
CGACCATACCATCGTGCCACCCGGGGTTAG|TAAAATCCGGTTAGCAGAGGAGTAGAAATG
TAGGGGCGGAACGTGGCATCTTTATCCGAA|TCCGATAAAATGAATTCGTCCTTGGGCGTT
AAAATCCGGTTAGCAGTGCTCCTTACGGAT|TGGCTAGTTTTATGACGTCCCTCCGAACCG
AAATCCGGTTAGCAGTGGCCCTGCTACCTA|CTACCATACGAAATAAAATCCGGTTAGCAG
GTTCTTAGCGTCGCTCACGGTACGCTAAAA|CATACGAAATAAAATCCGGTTAGCAGGACA
TACGAAATAAAATCCGGTTAGCAGTGCTCC|TAGCAGACTGGCTAGTTTTATGACGTCCCT
TGCGTACGACTAGCTACCATACGAAATAAA|CCGGAACGAACACGCTACGACAACGTGCGC
GCGCACGCGAAGGCGTTTTCACGCTTATTT|AGAGGAAAACCACGGGAGGGTTTGGCCCGA
TTATCCTCAAATAACATAGTTGTGATTTAG|CACGGGCAGTCGACCGCTCTACCATACGAA
AGCCTACCATACGAAATAAAATCCGGTTAG|CTGTCCCTACCATACGAACTACCATACGAA
TCGGTTTCTTTCCAGCACGGGCAGTCGACC|GCTTTTCAATGAGCCCCCTACGACCATACC
GTTTAGCGCAACGAAAACGAGCTTCAACCG|TCCGGGGCCTTAATTCTCAGCTCACTACTA
GCCGTCGGTTTCTTTCCAGCACGGGCAGTC|ACACGCTTTTCAATGAGCCCCCTACGACCA
ATACGAAATAAAATCCGGTTAGCAGTGGCC|ACCATACGAACTACCATACGAAATAAAATC
TTGGCCCGAAGTACGGACTACCATACGAAA|ATCTTCCGGGGCTAATAAAGATTACCGTTC
ATTCTCAGCTCACTACTACCATACGAAATA|CCATACGAAATAAAATCCGGTTAGCAGACT
GCTAATAAAGATTACCGTTCTTAGCGTCGC|TTTTCTGTGGCGCTACCATACGAAATAAAA
ACGTGGCATCTTTATCCGAAGTTAGCATTG|TGAATTCGTCCTTGGGCGTTCGGAAGCAAG
CCATACGAAATAAAATCCGGTTAGCAGTGC|GGTTAGCAGACTGGCTAGTTTTATGACGTC
CATACCATCGTGCCACCCGGGGTTAGTAGC|ATCCGGTTAGCAGAGGAGTAGAAATGTTTA
CGCGAAGGCGTTTTCACGCTTATTTCCGGG|AAAACCACGGGAGGGTTTGGCCCGAAGTAC
GGCGTTTTCACGCTTATTTCCGGGGCCTTA|ACGGGAGGGTTTGGCCCGAAGTACGGACTA
AAAACTTGATTAAGGGCTTAGGGGCGGAAC|GACACTTGCCTTCGAAAGTCCGATAAAATG
CACGAGGAGTCCAAGCACTCATTTAAAATG|TACGAAATAAAATCCGGTTAGCAGTGCTCC
CCGATTTTTCTGTGGCGCTACCATACGAAA|TGTTCATCACATCGTGTCGAGACCCTGCTT
GCCCCCTACGACCATACCATCGTGCCACCC|ATACGAAATAAAATCCGGTTAGCAGAGGAG
CAACGAAAACGAGCTTCAACCGGAGCACGA|CTTAATTCTCAGCTCACTACTACCATACGA
CTATGGGAAGCCTACCATACGAAATAAAAT|GGTGTTTCCTGTCCCTACCATACGAACTAC
CGGGGTTAGTAGCATCATGTATTAAGCTAC|GTAGAAATGTTTAGCGCAACGAAAACGAGC
CCCTTGAGAGTGGGCCGTCGGTTTCTTTCC|TCTCTGCTCTTCTACACGCTTTTCAATGAG
CACGGTACGCTAAAACTTGATTAAGGGCTT|CCGGTTAGCAGGACACTTGCCTTCGAAAGT
TCCGGTTAGCAGCTATGGGAAGCCTACCAT|ATCCGGTTAGCAGGTGTTTCCTGTCCCTAC
GCAGTCGACCGCTCTACCATACGAAATAAA|CGACCATACCATCGTGCCACCCGGGGTTAG
CCATACGAAATAAAATCCGGTTAGCAGGAA|ATAAAATCCTACCATACGAAATAAAATCCG
TCACTACTACCATACGAAATAAAATCCGGT|ATAAAATCCGGTTAGCAGACTGGCTAGTTT
GGGGCTAATAAAGATTACCGTTCTTAGCGT|GATTTTTCTGTGGCGCTACCATACGAAATA
TGGCCCGAAGTACGGACTACCATACGAAAT|TCTTCCGGGGCTAATAAAGATTACCGTTCT
TTAGCAGCTATGGGAAGCCTACCATACGAA|GTTAGCAGGTGTTTCCTGTCCCTACCATAC
GCTACCATACGAAATAAAATCCGGTTAGCA|CGCTACGACAACGTGCGCACGCGAAGGCGT
TAAAATCCGGTTAGCAGGGGATGAATAGGC|AGCACGAGGAGTCCAAGCACTCATTTAAAA
CTTTTCAATGAGCCCCCTACGACCATACCA|GACTAGCTACCATACGAAATAAAATCCGGT
GTTAGCAGAGGAGTAGAAATGTTTAGCGCA|AAGGCGTTTTCACGCTTATTTCCGGGGCCT
TAGCAGGTGTTTCCTGTCCCTACCATACGA|TCAAATAACATAGTTGTGATTTAGTGCAAG
TAGCATTGCCGCCACTAGAAGGCGGTGGGG|GAAGCAAGCGCGCGTTTTAGTGAAGCAGGT
CCATACCATCGTGCCACCCGGGGTTAGTAG|AATCCGGTTAGCAGAGGAGTAGAAATGTTT
TAGCAGGTGGTGCTCTACCTGTTATCCTCA|GGGCCGTCGGTTTCTTTCCAGCACGGGCAG
CCATACGAAATAAAATCCGGTTAGCAGGGG|ATAAAATCCGGTTAGCAGGGGATGAATAGG
AATCCGGTTAGCAGAGAGGAAAACCACGGG|CCAATCAGGGAGGACGCTTGGCCCATTCTC
AATCTCTCTAGTTCATTACACCTGGCACGG|CAGGTATCAAGGATATCTACCATACGAAAT
CCCGGGGTTAGTAGCATCATGTATTAAGCT|GAGTAGAAATGTTTAGCGCAACGAAAACGA
ACGAAATAAAATCCGGTTAGCAGTGCTCCT|AGCAGACTGGCTAGTTTTATGACGTCCCTC
CTGTTATCCTCAAATAACATAGTTGTGATT|CAGCACGGGCAGTCGACCGCTCTACCATAC
TGATTTAGTGCAAGGTCCAAAGGAATCTCT|CATACGAAATAAAATCCGGTTAGCAGGTAT
AGGAATTGCGTACGACTAGCTACCATACGA|TGTTAGCCGGAACGAACACGCTACGACAAC
CTACCATACGAAATAAAATCCGGTTAGCAG|GAAATAAAATCCGGTTAGCAGGGGATGAAT
GGACTACCATACGAAATAAAATCCGGTTAG|ATAAAGATTACCGTTCTTAGCGTCGCTCAC
GGCGGTGGGGGATCCGATTTTTCTGTGGCG|TGAAGCAGGTTTGTGTTCATCACATCGTGT
AATGTTTAGCGCAACGAAAACGAGCTTCAA|ATTTCCGGGGCCTTAATTCTCAGCTCACTA
AGCTCACTACTACCATACGAAATAAAATCC|GAAATAAAATCCGGTTAGCAGACTGGCTAG
TCATTACACCTGGCACGGCTTCAAAGACCA|ATATCTACCATACGAAATAAAATCCGGTTA
CGAAATAAAATCCGGTTAGCAGATAAAATC|AATCTCTCTAGTTCATTACACCTGGCACGG
TCCACATCTTCCGGGGCTAATAAAGATTAC|GGTGGGGGATCCGATTTTTCTGTGGCGCTA
TGCAAGGTCCAAAGGAATCTCTCTAGTTCA|ATAAAATCCGGTTAGCAGGTATCAAGGATA
GCGCAACGAAAACGAGCTTCAACCGGAGCA|GGCCTTAATTCTCAGCTCACTACTACCATA
TTCTTAGCGTCGCTCACGGTACGCTAAAAC|ATACGAAATAAAATCCGGTTAGCAGGACAC
ACCATACGAAATAAAATCCGGTTAGCAGAT|CAAAGGAATCTCTCTAGTTCATTACACCTG
ACGGTACGCTAAAACTTGATTAAGGGCTTA|CGGTTAGCAGGACACTTGCCTTCGAAAGTC
AAATAAAATCCGGTTAGCAGAGGAGTAGAA|CGTGCGCACGCGAAGGCGTTTTCACGCTTA
CCAGTCGACATTCCAATCAGGGAGGACGCT|TGGCATCTTTATCCGAAGTTAGCATTGCCG
CGATTTTTCTGTGGCGCTACCATACGAAAT|GTTCATCACATCGTGTCGAGACCCTGCTTA
ATCCTCAAATAACATAGTTGTGATTTAGTG|CGGGCAGTCGACCGCTCTACCATACGAAAT
GAAGTCCTCACAGGGACCCTACCATACGAA|CCGGTTAGCAGCGGTTAGCAGGTGGTGCTC
GAAATAAAATCCGGTTAGCAGGACACTTGC|GCTTAACGATTTTCCTAGCAGACACTTGCT
AAACCACGGGAGGGTTTGGCCCGAAGTACG|GCCCATTCTCTCCACATCTTCCGGGGCTAA
CCTTAATTCTCAGCTCACTACTACCATACG|GACTACCATACGAAATAAAATCCGGTTAGC
ATACGAAATAAAATCCGGTTAGCAGTGCTC|TTAGCAGACTGGCTAGTTTTATGACGTCCC
CATTCTCTCCACATCTTCCGGGGCTAATAA|AGAAGGCGGTGGGGGATCCGATTTTTCTGT
ATAGGCCGCCAAAAAGGAATTGCGTACGAC|TTAAAATGCGTCGTTGTTAGCCGGAACGAA
CTACTACCATACGAAATAAAATCCGGTTAG|AAATCCGGTTAGCAGACTGGCTAGTTTTAT
ATCCTACCATACGAAATAAAATCCGGTTAG|CGGCTTCAAAGACCAATAGCCGGCGACCCT
TCGCTCACGGTACGCTAAAACTTGATTAAG|AAAATCCGGTTAGCAGGACACTTGCCTTCG
GCTCTACCATACGAAATAAAATCCGGTTAG|ATCGTGCCACCCGGGGTTAGTAGCATCATG
GGTTAGCAGCGGTTAGCAGGTGGTGCTCTA|GACCCTTGAGAGTGGGCCGTCGGTTTCTTT
ATCATGTATTAAGCTACCATACGAAATAAA|GCGCAACGAAAACGAGCTTCAACCGGAGCA
GAACACGCTACGACAACGTGCGCACGCGAA|AATAAAATCCGGTTAGCAGAGAGGAAAACC
GTTAGCAGCTATGGGAAGCCTACCATACGA|GGTTAGCAGGTGTTTCCTGTCCCTACCATA
GTTTCCTGTCCCTACCATACGAACTACCAT|CATAGTTGTGATTTAGTGCAAGGTCCAAAG
AACATAGTTGTGATTTAGTGCAAGGTCCAA|ACCGCTCTACCATACGAAATAAAATCCGGT
